AAAAACACTTGCACAGTCT -> AAAACACTTGCACAGTCTT
AAAAACGATTATCCATGTA -> AAAACGATTATCCATGTAT
AAAAATGAGCGACGCTTGG -> AAAATGAGCGACGCTTGGG
AAAACACTTGCACAGTCTT -> AAACACTTGCACAGTCTTC
AAAACATCCAAGACAATGG -> AAACATCCAAGACAATGGA
AAAACGATTATCCATGTAT -> AAACGATTATCCATGTATG
AAAACGCTCGGTGTCCCCC -> AAACGCTCGGTGTCCCCCT
AAAAGGATAATCGAATATC -> AAAGGATAATCGAATATCG
AAAATCAAAACGCTCGGTG -> AAATCAAAACGCTCGGTGT
AAAATGAGCGACGCTTGGG -> AAATGAGCGACGCTTGGGT
AAACACTTGCACAGTCTTC -> AACACTTGCACAGTCTTCT
AAACATCCAAGACAATGGA -> AACATCCAAGACAATGGAT
AAACATTTTAGGTGCACGT -> AACATTTTAGGTGCACGTA
AAACGATTATCCATGTATG -> AACGATTATCCATGTATGC
AAACGCTCGGTGTCCCCCT -> AACGCTCGGTGTCCCCCTC
AAACGGCAAATGAGGGGAC -> AACGGCAAATGAGGGGACG
AAACGTAGACGTGACGGTT -> AACGTAGACGTGACGGTTA
AAACGTATAAGTCCGGCCA -> AACGTATAAGTCCGGCCAA
AAACGTGACCAACAGTAAT -> AACGTGACCAACAGTAATT
AAACTACTTGCTTCGGACA -> AACTACTTGCTTCGGACAG
AAAGAAACATTTTAGGTGC -> AAGAAACATTTTAGGTGCA
AAAGACTTACCCGTGCCCT -> AAGACTTACCCGTGCCCTA
AAAGAGAATTATACGTTAT -> AAGAGAATTATACGTTATA
AAAGAGCTAGACAGCTGAA -> AAGAGCTAGACAGCTGAAT
AAAGGATAATCGAATATCG -> AAGGATAATCGAATATCGT
AAAGGGACGTGATTGCGCA -> AAGGGACGTGATTGCGCAT
AAAGGTGCGCAACAACTTC -> AAGGTGCGCAACAACTTCA
AAATACTGTCTGAGGAGGG -> AATACTGTCTGAGGAGGGC
AAATCAAAACGCTCGGTGT -> AATCAAAACGCTCGGTGTC
AAATCAGAGGGGGACGTAT -> AATCAGAGGGGGACGTATT
AAATCCGGAGCATCCTGTC -> AATCCGGAGCATCCTGTCT
AAATCGATTCACAGGCGGC -> AATCGATTCACAGGCGGCC
AAATGAGCGACGCTTGGGT -> AATGAGCGACGCTTGGGTA
AAATGAGGGGACGGGAGTT -> AATGAGGGGACGGGAGTTC
AACAAAAATGAGCGACGCT -> ACAAAAATGAGCGACGCTT
AACAAACGGCAAATGAGGG -> ACAAACGGCAAATGAGGGG
AACAACTTCACGCCAGAAC -> ACAACTTCACGCCAGAACC
AACACTTGCACAGTCTTCT -> ACACTTGCACAGTCTTCTA
AACAGCCCGTGTCTTAGGG -> ACAGCCCGTGTCTTAGGGA
AACAGCCCGTGTCTTATCT -> ACAGCCCGTGTCTTATCTG
AACAGCCCGTGTCTTCGCG -> ACAGCCCGTGTCTTCGCGG
AACAGCCCGTGTCTTTACT -> ACAGCCCGTGTCTTTACTG
AACAGTAATTCCTTTGACG -> ACAGTAATTCCTTTGACGA
AACAGTAATTCGGGGAATG -> ACAGTAATTCGGGGAATGG
AACATACACTCACCGGAGC -> ACATACACTCACCGGAGCA
AACATCCAAGACAATGGAT -> ACATCCAAGACAATGGATT
AACATGAGCATGTGCTGTG -> ACATGAGCATGTGCTGTGA
AACATTGTGGAGGAATCTC -> ACATTGTGGAGGAATCTCA
AACATTTTAGGTGCACGTA -> ACATTTTAGGTGCACGTAA
AACCAGCTCCCTCTGAGCC -> ACCAGCTCCCTCTGAGCCC
AACCAGGAGCCGGAACTCA -> ACCAGGAGCCGGAACTCAA
AACCCCATCTATATCTGAT -> ACCCCATCTATATCTGATT
AACCCTAATAACCGTGGTC -> ACCCTAATAACCGTGGTCT
AACCCTTGGAGTTTATCCC -> ACCCTTGGAGTTTATCCCC
AACCGCATCACGTCCTTAG -> ACCGCATCACGTCCTTAGA
AACCGTGGTCTGCAGGCCA -> ACCGTGGTCTGCAGGCCAC
AACGAATCGTGATTGGGGC -> ACGAATCGTGATTGGGGCG
AACGATTATCCATGTATGC -> ACGATTATCCATGTATGCC
AACGCGCGGGCTGGATTCA -> ACGCGCGGGCTGGATTCAC
AACGCTCGGTGTCCCCCTC -> ACGCTCGGTGTCCCCCTCG
AACGGCAAATGAGGGGACG -> ACGGCAAATGAGGGGACGG
AACGTAGACGTGACGGTTA -> ACGTAGACGTGACGGTTAT
AACGTATAAGTCCGGCCAA -> ACGTATAAGTCCGGCCAAG
AACGTGACCAACAGTAATT -> ACGTGACCAACAGTAATTC
AACGTGCAAATACTGTCTG -> ACGTGCAAATACTGTCTGA
AACGTGGCCTCCCTGGCCG -> ACGTGGCCTCCCTGGCCGT
AACTAAGTAGAAGGTCCCC -> ACTAAGTAGAAGGTCCCCG
AACTAATTACTCGGAGGAG -> ACTAATTACTCGGAGGAGT
AACTACTTGCTTCGGACAG -> ACTACTTGCTTCGGACAGG
AACTAGGTGACGAGGGCTC -> ACTAGGTGACGAGGGCTCC
AACTCAAGCGGAGGGGTTC -> ACTCAAGCGGAGGGGTTCA
AACTCAATTCATGATACCG -> ACTCAATTCATGATACCGA
AACTGTCAAATCAGAGGGG -> ACTGTCAAATCAGAGGGGG
AACTTCACGCCAGAACCAG -> ACTTCACGCCAGAACCAGC
AAGAAAACATCCAAGACAA -> AGAAAACATCCAAGACAAT
AAGAAACATTTTAGGTGCA -> AGAAACATTTTAGGTGCAC
AAGAACCCCATCTATATCT -> AGAACCCCATCTATATCTG
AAGAACGTGCAAATACTGT -> AGAACGTGCAAATACTGTC
AAGAAGGTCCCCGAGGGAC -> AGAAGGTCCCCGAGGGACA
AAGACAATGGATTTCCGAG -> AGACAATGGATTTCCGAGG
AAGACTTACCCGTGCCCTA -> AGACTTACCCGTGCCCTAC
AAGAGAATTATACGTTATA -> AGAGAATTATACGTTATAA
AAGAGCTAGACAGCTGAAT -> AGAGCTAGACAGCTGAATC
AAGAGTAAAAACGATTATC -> AGAGTAAAAACGATTATCC
AAGATACATTAGTTACGTT -> AGATACATTAGTTACGTTG
AAGCATTCGTGCATCACAA -> AGCATTCGTGCATCACAAT
AAGCCCTAACTAGGTGACG -> AGCCCTAACTAGGTGACGA
AAGCGGAGGGGTTCAGAAC -> AGCGGAGGGGTTCAGAACG
AAGCGGCTTGCGGCTCGGC -> AGCGGCTTGCGGCTCGGCA
AAGCTCTTTTCTGCGGGCA -> AGCTCTTTTCTGCGGGCAG
AAGCTTTGGTATGTCTTGG -> AGCTTTGGTATGTCTTGGC
AAGGATAATCGAATATCGT -> AGGATAATCGAATATCGTA
AAGGGACGTGATTGCGCAT -> AGGGACGTGATTGCGCATC
AAGGTAGATGATTGATCTC -> AGGTAGATGATTGATCTCA
AAGGTCCCCGAGGGACAGG -> AGGTCCCCGAGGGACAGGA
AAGGTCCCCGAGGGACCGG -> AGGTCCCCGAGGGACCGGT
AAGGTCCCCGAGGGACGCT -> AGGTCCCCGAGGGACGCTC
AAGGTCCCCGAGGGACTAT -> AGGTCCCCGAGGGACTATG
AAGGTGCGCAACAACTTCA -> AGGTGCGCAACAACTTCAC
AAGGTGGCGGTGAGAGCGC -> AGGTGGCGGTGAGAGCGCG
AAGTAGAAGGTCCCCGAGG -> AGTAGAAGGTCCCCGAGGG
AAGTCAGGAAAAACACTTG -> AGTCAGGAAAAACACTTGC
AAGTCAGTACTATTTCGCG -> AGTCAGTACTATTTCGCGG
AAGTCCGGCCAAGTGGGCT -> AGTCCGGCCAAGTGGGCTT
AAGTGGGCTTCGGAGAAGG -> AGTGGGCTTCGGAGAAGGT
AAGTTAAGTTTACTTAGAG -> AGTTAAGTTTACTTAGAGG
AAGTTGCGCCGTCAGATCG -> AGTTGCGCCGTCAGATCGC
AAGTTTACTTAGAGGGTTA -> AGTTTACTTAGAGGGTTAA
AAGTTTCATCCTCTAAGAA -> AGTTTCATCCTCTAAGAAC
AATAACCGTGGTCTGCAGG -> ATAACCGTGGTCTGCAGGC
AATACCCTTGACTCACTAT -> ATACCCTTGACTCACTATC
AATACGCTATAACTAATTA -> ATACGCTATAACTAATTAC
AATACTGTCTGAGGAGGGC -> ATACTGTCTGAGGAGGGCC
AATATACGATTGGAGGCCA -> ATATACGATTGGAGGCCAG
AATATCGTAAAGGTGCGCA -> ATATCGTAAAGGTGCGCAA
AATCAAAACGCTCGGTGTC -> ATCAAAACGCTCGGTGTCC
AATCAACCCTAATAACCGT -> ATCAACCCTAATAACCGTG
AATCAGAAGGTCCCCGAGG -> ATCAGAAGGTCCCCGAGGG
AATCAGAGGGGGACGTATT -> ATCAGAGGGGGACGTATTC
AATCCGGAGCATCCTGTCT -> ATCCGGAGCATCCTGTCTA
AATCGAATATCGTAAAGGT -> ATCGAATATCGTAAAGGTG
AATCGATTCACAGGCGGCC -> ATCGATTCACAGGCGGCCG
AATCGTGATTGGGGCGCTA -> ATCGTGATTGGGGCGCTAC
AATCTACGCATATGGTATT -> ATCTACGCATATGGTATTG
AATCTCATGTACTAGATAT -> ATCTCATGTACTAGATATA
AATGAGCGACGCTTGGGTA -> ATGAGCGACGCTTGGGTAC
AATGAGGCGAGTGCAGTCC -> ATGAGGCGAGTGCAGTCCA
AATGAGGGGACGGGAGTTC -> ATGAGGGGACGGGAGTTCG
AATGCTCCGTTTGCTCCAG -> ATGCTCCGTTTGCTCCAGG
AATGGATATCCTATTAAGA -> ATGGATATCCTATTAAGAA
AATGGATTTCCGAGGGTTA -> ATGGATTTCCGAGGGTTAG
AATGGCAAAGAGAATTATA -> ATGGCAAAGAGAATTATAC
AATTACCACTGGGCGATAC -> ATTACCACTGGGCGATACC
AATTACTCGGAGGAGTAAC -> ATTACTCGGAGGAGTAACG
AATTATACGTTATAACTAA -> ATTATACGTTATAACTAAG
AATTCATGATACCGATAAA -> ATTCATGATACCGATAAAT
AATTCCAAACTACTTGCTT -> ATTCCAAACTACTTGCTTC
AATTCCTTTGACGAACGTG -> ATTCCTTTGACGAACGTGG
AATTCGGGGAATGGCAAAG -> ATTCGGGGAATGGCAAAGA
AATTGCTCATCCACGAGTA -> ATTGCTCATCCACGAGTAG
ACAAAAATGAGCGACGCTT -> CAAAAATGAGCGACGCTTG
ACAAACGGCAAATGAGGGG -> CAAACGGCAAATGAGGGGA
ACAAAGGGACGTGATTGCG -> CAAAGGGACGTGATTGCGC
ACAACTTCACGCCAGAACC -> CAACTTCACGCCAGAACCA
ACAAGCTCTTTTCTGCGGG -> CAAGCTCTTTTCTGCGGGC
ACAATATACGATTGGAGGC -> CAATATACGATTGGAGGCC
ACAATGGATTTCCGAGGGT -> CAATGGATTTCCGAGGGTT
ACACAAGCTCTTTTCTGCG -> CACAAGCTCTTTTCTGCGG
ACACAGCCAAACGTGACCA -> CACAGCCAAACGTGACCAA
ACACAGGGGTGACTTCGAA -> CACAGGGGTGACTTCGAAC
ACACCGTCGATCTCATAGG -> CACCGTCGATCTCATAGGA
ACACTCACCGGAGCATAAC -> CACTCACCGGAGCATAACT
ACACTTGCACAGTCTTCTA -> CACTTGCACAGTCTTCTAC
ACAGATCAGTTAAGCCCTA -> CAGATCAGTTAAGCCCTAA
ACAGCCAAACGTGACCAAC -> CAGCCAAACGTGACCAACA
ACAGCCCGTGTCTTAGGGA -> CAGCCCGTGTCTTAGGGAC
ACAGCCCGTGTCTTATCTG -> CAGCCCGTGTCTTATCTGT
ACAGCCCGTGTCTTCGCGG -> CAGCCCGTGTCTTCGCGGT
ACAGCCCGTGTCTTTACTG -> CAGCCCGTGTCTTTACTGA
ACAGCTCGTAGTGACCCAT -> CAGCTCGTAGTGACCCATG
ACAGCTGAATCAGAAGGTC -> CAGCTGAATCAGAAGGTCC
ACAGGAGCCTTTCGCGGAA -> CAGGAGCCTTTCGCGGAAC
ACAGGCGGCCGAGTTTACA -> CAGGCGGCCGAGTTTACAC
ACAGGCTAGACACCGTCGA -> CAGGCTAGACACCGTCGAT
ACAGGGGTGACTTCGAACA -> CAGGGGTGACTTCGAACAT
ACAGTAATTCCTTTGACGA -> CAGTAATTCCTTTGACGAA
ACAGTAATTCGGGGAATGG -> CAGTAATTCGGGGAATGGC
ACAGTCTTCTACGGACGTG -> CAGTCTTCTACGGACGTGA
ACATACACTCACCGGAGCA -> CATACACTCACCGGAGCAT
ACATACCGGGCTAGCTTCG -> CATACCGGGCTAGCTTCGG
ACATATAAAGAGCTAGACA -> CATATAAAGAGCTAGACAG
ACATATTAAAAGGATAATC -> CATATTAAAAGGATAATCG
ACATCCAAGACAATGGATT -> CATCCAAGACAATGGATTT
ACATGAGCATGTGCTGTGA -> CATGAGCATGTGCTGTGAA
ACATTACATATAAAGAGCT -> CATTACATATAAAGAGCTA
ACATTAGTTACGTTGCAGT -> CATTAGTTACGTTGCAGTG
ACATTCGTGTCGATTTCAC -> CATTCGTGTCGATTTCACG
ACATTGTGGAGGAATCTCA -> CATTGTGGAGGAATCTCAT
ACATTTCGGGCACTTTTCG -> CATTTCGGGCACTTTTCGT
ACATTTTAGGTGCACGTAA -> CATTTTAGGTGCACGTAAA
ACCAACAGTAATTCGGGGA -> CCAACAGTAATTCGGGGAA
ACCACTGGGCGATACCTCA -> CCACTGGGCGATACCTCAA
ACCAGCTCCCTCTGAGCCC -> CCAGCTCCCTCTGAGCCCT
ACCAGGAGCCGGAACTCAA -> CCAGGAGCCGGAACTCAAT
ACCATAATTCCAAACTACT -> CCATAATTCCAAACTACTT
ACCCATGAACAGTAATTCC -> CCCATGAACAGTAATTCCT
ACCCCATCTATATCTGATT -> CCCCATCTATATCTGATTG
ACCCGTGCCCTACATTCGT -> CCCGTGCCCTACATTCGTG
ACCCTAATAACCGTGGTCT -> CCCTAATAACCGTGGTCTG
ACCCTGATAAGAAAACATC -> CCCTGATAAGAAAACATCC
ACCCTTGACTCACTATCGC -> CCCTTGACTCACTATCGCC
ACCCTTGGAGTTTATCCCC -> CCCTTGGAGTTTATCCCCA
ACCGATAAATCCGGAGCAT -> CCGATAAATCCGGAGCATC
ACCGCATCACGTCCTTAGA -> CCGCATCACGTCCTTAGAC
ACCGGAGCATAACTGTCAA -> CCGGAGCATAACTGTCAAA
ACCGGGCTAGCTTCGGTTC -> CCGGGCTAGCTTCGGTTCG
ACCGGGTGTCCGGACGGTC -> CCGGGTGTCCGGACGGTCT
ACCGGTACGTGATGCGGAA -> CCGGTACGTGATGCGGAAC
ACCGTCGATCTCATAGGAT -> CCGTCGATCTCATAGGATT
ACCGTGGTCTGCAGGCCAC -> CCGTGGTCTGCAGGCCACG
ACCGTGTTAAGATACATTA -> CCGTGTTAAGATACATTAG
ACCTCAACCCTTGGAGTTT -> CCTCAACCCTTGGAGTTTA
ACCTCAGATCACATTTCGG -> CCTCAGATCACATTTCGGG
ACGAACGTGGCCTCCCTGG -> CGAACGTGGCCTCCCTGGC
ACGAAGCATTCGTGCATCA -> CGAAGCATTCGTGCATCAC
ACGAATCGTGATTGGGGCG -> CGAATCGTGATTGGGGCGC
ACGACCGTGTTAAGATACA -> CGACCGTGTTAAGATACAT
ACGAGGGCTCCGTCATGTG -> CGAGGGCTCCGTCATGTGC
ACGAGTAGAAATCGATTCA -> CGAGTAGAAATCGATTCAC
ACGATTATCCATGTATGCC -> CGATTATCCATGTATGCCC
ACGATTGGAGGCCAGGCTC -> CGATTGGAGGCCAGGCTCG
ACGCACTACGGATCATACT -> CGCACTACGGATCATACTG
ACGCATATGGTATTGAGGC -> CGCATATGGTATTGAGGCT
ACGCCAGAACCAGCTCCCT -> CGCCAGAACCAGCTCCCTC
ACGCCATTCCGGCTCTGCA -> CGCCATTCCGGCTCTGCAG
ACGCGCGGGCTGGATTCAC -> CGCGCGGGCTGGATTCACC
ACGCTATAACTAATTACTC -> CGCTATAACTAATTACTCG
ACGCTCGGTGTCCCCCTCG -> CGCTCGGTGTCCCCCTCGC
ACGCTCGTACGCTGGAAGT -> CGCTCGTACGCTGGAAGTC
ACGCTCTTGTGAGGCGGAA -> CGCTCTTGTGAGGCGGAAC
ACGCTGGAAGTCAGTACTA -> CGCTGGAAGTCAGTACTAT
ACGCTTGGGTACAGCTCGT -> CGCTTGGGTACAGCTCGTA
ACGGACGTGATCACGCACT -> CGGACGTGATCACGCACTA
ACGGAGTATGGTCGTTGAA -> CGGAGTATGGTCGTTGAAG
ACGGATCATACTGAGCTGC -> CGGATCATACTGAGCTGCC
ACGGATGCATACTATCTTT -> CGGATGCATACTATCTTTC
ACGGCAAATGAGGGGACGG -> CGGCAAATGAGGGGACGGG
ACGGCAGGGTATCGCATTT -> CGGCAGGGTATCGCATTTG
ACGGGAGTTCGCACGGCAG -> CGGGAGTTCGCACGGCAGG
ACGGTCTGCGAGTCTGAAC -> CGGTCTGCGAGTCTGAACA
ACGGTTATTCAGGCGCAAT -> CGGTTATTCAGGCGCAATT
ACGTAAAATCAAAACGCTC -> CGTAAAATCAAAACGCTCG
ACGTAAGAAGGTCCCCGAG -> CGTAAGAAGGTCCCCGAGG
ACGTAGACGTGACGGTTAT -> CGTAGACGTGACGGTTATT
ACGTATAAGTCCGGCCAAG -> CGTATAAGTCCGGCCAAGT
ACGTATTCCGGCGTGGCCA -> CGTATTCCGGCGTGGCCAT
ACGTCACGGATGCATACTA -> CGTCACGGATGCATACTAT
ACGTCCTTAGACTGTTTTT -> CGTCCTTAGACTGTTTTTA
ACGTGACCAACAGTAATTC -> CGTGACCAACAGTAATTCG
ACGTGACGGTTATTCAGGC -> CGTGACGGTTATTCAGGCG
ACGTGATCACGCACTACGG -> CGTGATCACGCACTACGGA
ACGTGATGCGGAACAGCCC -> CGTGATGCGGAACAGCCCG
ACGTGATTGCGCATCGACA -> CGTGATTGCGCATCGACAC
ACGTGCAAATACTGTCTGA -> CGTGCAAATACTGTCTGAG
ACGTGGCCTCCCTGGCCGT -> CGTGGCCTCCCTGGCCGTA
ACGTTATAACTAAGTAGAA -> CGTTATAACTAAGTAGAAG
ACGTTGCAGTGTGGTAAGA -> CGTTGCAGTGTGGTAAGAG
ACTAAGTAGAAGGTCCCCG -> CTAAGTAGAAGGTCCCCGA
ACTAATTACTCGGAGGAGT -> CTAATTACTCGGAGGAGTA
ACTACCCTGATAAGAAAAC -> CTACCCTGATAAGAAAACA
ACTACGGATCATACTGAGC -> CTACGGATCATACTGAGCT
ACTACTTGCTTCGGACAGG -> CTACTTGCTTCGGACAGGC
ACTAGAAAGAAACATTTTA -> CTAGAAAGAAACATTTTAG
ACTAGATATAAGTTAAGTT -> CTAGATATAAGTTAAGTTT
ACTAGGTGACGAGGGCTCC -> CTAGGTGACGAGGGCTCCG
ACTATATAATCTACGCATA -> CTATATAATCTACGCATAT
ACTATCGCCCGTCAGCGTA -> CTATCGCCCGTCAGCGTAC
ACTATCTTTCGGAGCTAGC -> CTATCTTTCGGAGCTAGCA
ACTATGGGCGCTTGCGGAA -> CTATGGGCGCTTGCGGAAC
ACTATTTCGCGGTGCAATA -> CTATTTCGCGGTGCAATAT
ACTCAAGCGGAGGGGTTCA -> CTCAAGCGGAGGGGTTCAG
ACTCAATTCATGATACCGA -> CTCAATTCATGATACCGAT
ACTCACCGGAGCATAACTG -> CTCACCGGAGCATAACTGT
ACTCACTATCGCCCGTCAG -> CTCACTATCGCCCGTCAGC
ACTCGGAGGAGTAACGAAT -> CTCGGAGGAGTAACGAATC
ACTCGTATGCATACTTAAT -> CTCGTATGCATACTTAATC
ACTGAGATGGTCGTGGGCA -> CTGAGATGGTCGTGGGCAT
ACTGAGCTGCCCTGCATGC -> CTGAGCTGCCCTGCATGCT
ACTGGGCGATACCTCAACC -> CTGGGCGATACCTCAACCC
ACTGTAATTGCTCATCCAC -> CTGTAATTGCTCATCCACG
ACTGTCAAATCAGAGGGGG -> CTGTCAAATCAGAGGGGGA
ACTGTCTGAGGAGGGCCCC -> CTGTCTGAGGAGGGCCCCT
ACTGTTTTTAGCCAATGAG -> CTGTTTTTAGCCAATGAGG
ACTTAATCAACCCTAATAA -> CTTAATCAACCCTAATAAC
ACTTACCCGTGCCCTACAT -> CTTACCCGTGCCCTACATT
ACTTAGAGGGTTAAGTTTC -> CTTAGAGGGTTAAGTTTCA
ACTTCACGCCAGAACCAGC -> CTTCACGCCAGAACCAGCT
ACTTCGAACATTGTGGAGG -> CTTCGAACATTGTGGAGGA
ACTTGCACAGTCTTCTACG -> CTTGCACAGTCTTCTACGG
ACTTGCTTCGGACAGGCTA -> CTTGCTTCGGACAGGCTAG
ACTTTTCGTAGGAGCAACA -> CTTTTCGTAGGAGCAACAT
AGAAAACATCCAAGACAAT -> GAAAACATCCAAGACAATG
AGAAACATTTTAGGTGCAC -> GAAACATTTTAGGTGCACG
AGAAAGAAACATTTTAGGT -> GAAAGAAACATTTTAGGTG
AGAAATCGATTCACAGGCG -> GAAATCGATTCACAGGCGG
AGAACCAGCTCCCTCTGAG -> GAACCAGCTCCCTCTGAGC
AGAACCCCATCTATATCTG -> GAACCCCATCTATATCTGA
AGAACGCGCGGGCTGGATT -> GAACGCGCGGGCTGGATTC
AGAACGTGCAAATACTGTC -> GAACGTGCAAATACTGTCT
AGAAGCTTTGGTATGTCTT -> GAAGCTTTGGTATGTCTTG
AGAAGGTCCCCGAGGGACA -> GAAGGTCCCCGAGGGACAG
AGAAGGTCCCCGAGGGACC -> GAAGGTCCCCGAGGGACCG
AGAAGGTCCCCGAGGGACG -> GAAGGTCCCCGAGGGACGC
AGAAGGTCCCCGAGGGACT -> GAAGGTCCCCGAGGGACTA
AGAAGGTGGCGGTGAGAGC -> GAAGGTGGCGGTGAGAGCG
AGAATTATACGTTATAACT -> GAATTATACGTTATAACTA
AGACAATGGATTTCCGAGG -> GACAATGGATTTCCGAGGG
AGACACCGTCGATCTCATA -> GACACCGTCGATCTCATAG
AGACAGCTGAATCAGAAGG -> GACAGCTGAATCAGAAGGT
AGACGAAGCATTCGTGCAT -> GACGAAGCATTCGTGCATC
AGACGTCACGGATGCATAC -> GACGTCACGGATGCATACT
AGACGTGACGGTTATTCAG -> GACGTGACGGTTATTCAGG
AGACTGTAATTGCTCATCC -> GACTGTAATTGCTCATCCA
AGACTGTTTTTAGCCAATG -> GACTGTTTTTAGCCAATGA
AGACTTACCCGTGCCCTAC -> GACTTACCCGTGCCCTACA
AGAGAATTATACGTTATAA -> GAGAATTATACGTTATAAC
AGAGCGCGACATACCGGGC -> GAGCGCGACATACCGGGCT
AGAGCTAGACAGCTGAATC -> GAGCTAGACAGCTGAATCA
AGAGGGGGACGTATTCCGG -> GAGGGGGACGTATTCCGGC
AGAGGGTTAAGTTTCATCC -> GAGGGTTAAGTTTCATCCT
AGAGTAAAAACGATTATCC -> GAGTAAAAACGATTATCCA
AGATACATTAGTTACGTTG -> GATACATTAGTTACGTTGC
AGATATAAGTTAAGTTTAC -> GATATAAGTTAAGTTTACT
AGATCACATTTCGGGCACT -> GATCACATTTCGGGCACTT
AGATCAGTTAAGCCCTAAC -> GATCAGTTAAGCCCTAACT
AGATCGCCAAACGTATAAG -> GATCGCCAAACGTATAAGT
AGATGATTGATCTCACTAG -> GATGATTGATCTCACTAGA
AGATGGTCGTGGGCATTAC -> GATGGTCGTGGGCATTACA
AGCAAACGTAGACGTGACG -> GCAAACGTAGACGTGACGG
AGCAACATGAGCATGTGCT -> GCAACATGAGCATGTGCTG
AGCACAAAGGGACGTGATT -> GCACAAAGGGACGTGATTG
AGCAGACGTCACGGATGCA -> GCAGACGTCACGGATGCAT
AGCATAACTGTCAAATCAG -> GCATAACTGTCAAATCAGA
AGCATCCTGTCTAACATAC -> GCATCCTGTCTAACATACA
AGCATGTGCTGTGAACCGC -> GCATGTGCTGTGAACCGCA
AGCATTCGTGCATCACAAT -> GCATTCGTGCATCACAATA
AGCATTGGAGGCGTACTAC -> GCATTGGAGGCGTACTACC
AGCCAAACGTGACCAACAG -> GCCAAACGTGACCAACAGT
AGCCAATGAGGCGAGTGCA -> GCCAATGAGGCGAGTGCAG
AGCCCGTGTCTTAGGGACA -> GCCCGTGTCTTAGGGACAT
AGCCCGTGTCTTATCTGTT -> GCCCGTGTCTTATCTGTTT
AGCCCGTGTCTTCGCGGTC -> GCCCGTGTCTTCGCGGTCA
AGCCCGTGTCTTTACTGAG -> GCCCGTGTCTTTACTGAGA
AGCCCTAACTAGGTGACGA -> GCCCTAACTAGGTGACGAG
AGCCCTCACATTACATATA -> GCCCTCACATTACATATAA
AGCCCTGGAAGTTGCGCCG -> GCCCTGGAAGTTGCGCCGT
AGCCGCTTTCTCAGGAGTA -> GCCGCTTTCTCAGGAGTAA
AGCCGGAACTCAATTCATG -> GCCGGAACTCAATTCATGA
AGCCTTTCGCGGAACAGCC -> GCCTTTCGCGGAACAGCCC
AGCGACGCTTGGGTACAGC -> GCGACGCTTGGGTACAGCT
AGCGCGACATACCGGGCTA -> GCGCGACATACCGGGCTAG
AGCGGAGGGGTTCAGAACG -> GCGGAGGGGTTCAGAACGC
AGCGGCTTGCGGCTCGGCA -> GCGGCTTGCGGCTCGGCAA
AGCGTACTCGTATGCATAC -> GCGTACTCGTATGCATACT
AGCTAGACAGCTGAATCAG -> GCTAGACAGCTGAATCAGA
AGCTAGCACAAAGGGACGT -> GCTAGCACAAAGGGACGTG
AGCTCCCTCTGAGCCCTGG -> GCTCCCTCTGAGCCCTGGA
AGCTCGTAGTGACCCATGA -> GCTCGTAGTGACCCATGAA
AGCTCTTTTCTGCGGGCAG -> GCTCTTTTCTGCGGGCAGT
AGCTGAATCAGAAGGTCCC -> GCTGAATCAGAAGGTCCCC
AGCTGCCCTGCATGCTGGA -> GCTGCCCTGCATGCTGGAC
AGCTTCGGTTCGAACAAAC -> GCTTCGGTTCGAACAAACG
AGCTTTGGTATGTCTTGGC -> GCTTTGGTATGTCTTGGCT
AGGAAAAACACTTGCACAG -> GGAAAAACACTTGCACAGT
AGGAATCTCATGTACTAGA -> GGAATCTCATGTACTAGAT
AGGAGCAACATGAGCATGT -> GGAGCAACATGAGCATGTG
AGGAGCCGGAACTCAATTC -> GGAGCCGGAACTCAATTCA
AGGAGCCTTTCGCGGAACA -> GGAGCCTTTCGCGGAACAG
AGGAGGGCCCCTATATCCT -> GGAGGGCCCCTATATCCTA
AGGAGTAACGAATCGTGAT -> GGAGTAACGAATCGTGATT
AGGAGTAATACCCTTGACT -> GGAGTAATACCCTTGACTC
AGGATAATCGAATATCGTA -> GGATAATCGAATATCGTAA
AGGATTCGTTCTAAAGACT -> GGATTCGTTCTAAAGACTT
AGGCAAGGTAGATGATTGA -> GGCAAGGTAGATGATTGAT
AGGCCACGCTCGTACGCTG -> GGCCACGCTCGTACGCTGG
AGGCCAGGCTCGCTCCAGA -> GGCCAGGCTCGCTCCAGAA
AGGCGAGTGCAGTCCACTA -> GGCGAGTGCAGTCCACTAT
AGGCGCAATTACCACTGGG -> GGCGCAATTACCACTGGGC
AGGCGGAACAGCCCGTGTC -> GGCGGAACAGCCCGTGTCT
AGGCGGCCGAGTTTACACA -> GGCGGCCGAGTTTACACAG
AGGCGTACTACCCTGATAA -> GGCGTACTACCCTGATAAG
AGGCTAGACACCGTCGATC -> GGCTAGACACCGTCGATCT
AGGCTCGCTCCAGAAGGTG -> GGCTCGCTCCAGAAGGTGG
AGGCTGACGGAGTATGGTC -> GGCTGACGGAGTATGGTCG
AGGGACAGGAGCCTTTCGC -> GGGACAGGAGCCTTTCGCG
AGGGACATATTAAAAGGAT -> GGGACATATTAAAAGGATA
AGGGACCGGTACGTGATGC -> GGGACCGGTACGTGATGCG
AGGGACGCTCTTGTGAGGC -> GGGACGCTCTTGTGAGGCG
AGGGACGTGATTGCGCATC -> GGGACGTGATTGCGCATCG
AGGGACTATGGGCGCTTGC -> GGGACTATGGGCGCTTGCG
AGGGCCCCTATATCCTAAT -> GGGCCCCTATATCCTAATG
AGGGCTCCGTCATGTGCGA -> GGGCTCCGTCATGTGCGAC
AGGGGACGGGAGTTCGCAC -> GGGGACGGGAGTTCGCACG
AGGGGGACGTATTCCGGCG -> GGGGGACGTATTCCGGCGT
AGGGGTGACTTCGAACATT -> GGGGTGACTTCGAACATTG
AGGGGTTCAGAACGCGCGG -> GGGGTTCAGAACGCGCGGG
AGGGTATCGCATTTGAGAA -> GGGTATCGCATTTGAGAAG
AGGGTTAAGTTTCATCCTC -> GGGTTAAGTTTCATCCTCT
AGGGTTAGCCGCTTTCTCA -> GGGTTAGCCGCTTTCTCAG
AGGTAGATGATTGATCTCA -> GGTAGATGATTGATCTCAC
AGGTCCCCGAGGGACAGGA -> GGTCCCCGAGGGACAGGAG
AGGTCCCCGAGGGACCGGT -> GGTCCCCGAGGGACCGGTA
AGGTCCCCGAGGGACGCTC -> GGTCCCCGAGGGACGCTCT
AGGTCCCCGAGGGACTATG -> GGTCCCCGAGGGACTATGG
AGGTGACGAGGGCTCCGTC -> GGTGACGAGGGCTCCGTCA
AGGTGCACGTAAAATCAAA -> GGTGCACGTAAAATCAAAA
AGGTGCGCAACAACTTCAC -> GGTGCGCAACAACTTCACG
AGGTGGCGGTGAGAGCGCG -> GGTGGCGGTGAGAGCGCGA
AGTAAAAACGATTATCCAT -> GTAAAAACGATTATCCATG
AGTAACGAATCGTGATTGG -> GTAACGAATCGTGATTGGG
AGTAATACCCTTGACTCAC -> GTAATACCCTTGACTCACT
AGTAATTCCTTTGACGAAC -> GTAATTCCTTTGACGAACG
AGTAATTCGGGGAATGGCA -> GTAATTCGGGGAATGGCAA
AGTACTATTTCGCGGTGCA -> GTACTATTTCGCGGTGCAA
AGTAGAAATCGATTCACAG -> GTAGAAATCGATTCACAGG
AGTAGAAGGTCCCCGAGGG -> GTAGAAGGTCCCCGAGGGA
AGTATGGTCGTTGAAGTCA -> GTATGGTCGTTGAAGTCAG
AGTCAGGAAAAACACTTGC -> GTCAGGAAAAACACTTGCA
AGTCAGTACTATTTCGCGG -> GTCAGTACTATTTCGCGGT
AGTCCACTATATAATCTAC -> GTCCACTATATAATCTACG
AGTCCGGCCAAGTGGGCTT -> GTCCGGCCAAGTGGGCTTC
AGTCTGAACAAAAATGAGC -> GTCTGAACAAAAATGAGCG
AGTCTTCTACGGACGTGAT -> GTCTTCTACGGACGTGATC
AGTGACCCATGAACAGTAA -> GTGACCCATGAACAGTAAT
AGTGCAGTCCACTATATAA -> GTGCAGTCCACTATATAAT
AGTGGGCTTCGGAGAAGGT -> GTGGGCTTCGGAGAAGGTC
AGTGTGGTAAGAGTAAAAA -> GTGTGGTAAGAGTAAAAAC
AGTTAAGCCCTAACTAGGT -> GTTAAGCCCTAACTAGGTG
AGTTAAGTTTACTTAGAGG -> GTTAAGTTTACTTAGAGGG
AGTTACGTTGCAGTGTGGT -> GTTACGTTGCAGTGTGGTA
AGTTATAGCATTGGAGGCG -> GTTATAGCATTGGAGGCGT
AGTTCGCACGGCAGGGTAT -> GTTCGCACGGCAGGGTATC
AGTTGCGCCGTCAGATCGC -> GTTGCGCCGTCAGATCGCC
AGTTTACACAGCCAAACGT -> GTTTACACAGCCAAACGTG
AGTTTACTTAGAGGGTTAA -> GTTTACTTAGAGGGTTAAG
AGTTTATCCCCAATACGCT -> GTTTATCCCCAATACGCTA
AGTTTCATCCTCTAAGAAC -> GTTTCATCCTCTAAGAACG
ATAAAGAGCTAGACAGCTG -> TAAAGAGCTAGACAGCTGA
ATAAATCCGGAGCATCCTG -> TAAATCCGGAGCATCCTGT
ATAACCGTGGTCTGCAGGC -> TAACCGTGGTCTGCAGGCC
ATAACTAAGTAGAAGGTCC -> TAACTAAGTAGAAGGTCCC
ATAACTAATTACTCGGAGG -> TAACTAATTACTCGGAGGA
ATAACTGTCAAATCAGAGG -> TAACTGTCAAATCAGAGGG
ATAAGAAAACATCCAAGAC -> TAAGAAAACATCCAAGACA
ATAAGTCCGGCCAAGTGGG -> TAAGTCCGGCCAAGTGGGC
ATAAGTTAAGTTTACTTAG -> TAAGTTAAGTTTACTTAGA
ATAATCGAATATCGTAAAG -> TAATCGAATATCGTAAAGG
ATAATCTACGCATATGGTA -> TAATCTACGCATATGGTAT
ATAATTCCAAACTACTTGC -> TAATTCCAAACTACTTGCT
ATACACTCACCGGAGCATA -> TACACTCACCGGAGCATAA
ATACATTAGTTACGTTGCA -> TACATTAGTTACGTTGCAG
ATACCCTTGACTCACTATC -> TACCCTTGACTCACTATCG
ATACCGATAAATCCGGAGC -> TACCGATAAATCCGGAGCA
ATACCGGGCTAGCTTCGGT -> TACCGGGCTAGCTTCGGTT
ATACCTCAACCCTTGGAGT -> TACCTCAACCCTTGGAGTT
ATACGATTGGAGGCCAGGC -> TACGATTGGAGGCCAGGCT
ATACGCTATAACTAATTAC -> TACGCTATAACTAATTACT
ATACGTTATAACTAAGTAG -> TACGTTATAACTAAGTAGA
ATACTATCTTTCGGAGCTA -> TACTATCTTTCGGAGCTAG
ATACTGAGCTGCCCTGCAT -> TACTGAGCTGCCCTGCATG
ATACTGTCTGAGGAGGGCC -> TACTGTCTGAGGAGGGCCC
ATACTTAATCAACCCTAAT -> TACTTAATCAACCCTAATA
ATAGACTGTAATTGCTCAT -> TAGACTGTAATTGCTCATC
ATAGCATTGGAGGCGTACT -> TAGCATTGGAGGCGTACTA
ATAGGATTCGTTCTAAAGA -> TAGGATTCGTTCTAAAGAC
ATATAAAGAGCTAGACAGC -> TATAAAGAGCTAGACAGCT
ATATAAGTTAAGTTTACTT -> TATAAGTTAAGTTTACTTA
ATATAATCTACGCATATGG -> TATAATCTACGCATATGGT
ATATACGATTGGAGGCCAG -> TATACGATTGGAGGCCAGG
ATATCCTAATGGATATCCT -> TATCCTAATGGATATCCTA
ATATCCTATTAAGAACCCC -> TATCCTATTAAGAACCCCA
ATATCGTAAAGGTGCGCAA -> TATCGTAAAGGTGCGCAAC
ATATCTGATTGGTTTTCGT -> TATCTGATTGGTTTTCGTT
ATATGGTATTGAGGCTGAC -> TATGGTATTGAGGCTGACG
ATATTAAAAGGATAATCGA -> TATTAAAAGGATAATCGAA
ATCAAAACGCTCGGTGTCC -> TCAAAACGCTCGGTGTCCC
ATCAACCCTAATAACCGTG -> TCAACCCTAATAACCGTGG
ATCACAATATACGATTGGA -> TCACAATATACGATTGGAG
ATCACATTTCGGGCACTTT -> TCACATTTCGGGCACTTTT
ATCACGCACTACGGATCAT -> TCACGCACTACGGATCATA
ATCACGTCCTTAGACTGTT -> TCACGTCCTTAGACTGTTT
ATCAGAAGGTCCCCGAGGG -> TCAGAAGGTCCCCGAGGGA
ATCAGAGGGGGACGTATTC -> TCAGAGGGGGACGTATTCC
ATCAGTTAAGCCCTAACTA -> TCAGTTAAGCCCTAACTAG
ATCATACTGAGCTGCCCTG -> TCATACTGAGCTGCCCTGC
ATCCAAGACAATGGATTTC -> TCCAAGACAATGGATTTCC
ATCCACGAGTAGAAATCGA -> TCCACGAGTAGAAATCGAT
ATCCATGTAGCAGACGTCA -> TCCATGTAGCAGACGTCAC
ATCCATGTATGCCCAGCCC -> TCCATGTATGCCCAGCCCT
ATCCCCAATACGCTATAAC -> TCCCCAATACGCTATAACT
ATCCGGAGCATCCTGTCTA -> TCCGGAGCATCCTGTCTAA
ATCCTAATGGATATCCTAT -> TCCTAATGGATATCCTATT
ATCCTATTAAGAACCCCAT -> TCCTATTAAGAACCCCATC
ATCCTCTAAGAACGTGCAA -> TCCTCTAAGAACGTGCAAA
ATCCTGTCTAACATACACT -> TCCTGTCTAACATACACTC
ATCGAATATCGTAAAGGTG -> TCGAATATCGTAAAGGTGC
ATCGACACAGGGGTGACTT -> TCGACACAGGGGTGACTTC
ATCGATTCACAGGCGGCCG -> TCGATTCACAGGCGGCCGA
ATCGCATTTGAGAAGCTTT -> TCGCATTTGAGAAGCTTTG
ATCGCCAAACGTATAAGTC -> TCGCCAAACGTATAAGTCC
ATCGCCCGTCAGCGTACTC -> TCGCCCGTCAGCGTACTCG
ATCGTAAAGGTGCGCAACA -> TCGTAAAGGTGCGCAACAA
ATCGTGATTGGGGCGCTAC -> TCGTGATTGGGGCGCTACA
ATCTACGCATATGGTATTG -> TCTACGCATATGGTATTGA
ATCTATATCTGATTGGTTT -> TCTATATCTGATTGGTTTT
ATCTCACTAGAAAGAAACA -> TCTCACTAGAAAGAAACAT
ATCTCATAGGATTCGTTCT -> TCTCATAGGATTCGTTCTA
ATCTCATGTACTAGATATA -> TCTCATGTACTAGATATAA
ATCTGATTGGTTTTCGTTA -> TCTGATTGGTTTTCGTTAT
ATCTGTTTTGCTTCGGTAG -> TCTGTTTTGCTTCGGTAGC
ATCTTTCGGAGCTAGCACA -> TCTTTCGGAGCTAGCACAA
ATGAACAGTAATTCCTTTG -> TGAACAGTAATTCCTTTGA
ATGACCTCAGATCACATTT -> TGACCTCAGATCACATTTC
ATGAGCATGTGCTGTGAAC -> TGAGCATGTGCTGTGAACC
ATGAGCGACGCTTGGGTAC -> TGAGCGACGCTTGGGTACA
ATGAGGCGAGTGCAGTCCA -> TGAGGCGAGTGCAGTCCAC
ATGAGGGGACGGGAGTTCG -> TGAGGGGACGGGAGTTCGC
ATGATACCGATAAATCCGG -> TGATACCGATAAATCCGGA
ATGATTGATCTCACTAGAA -> TGATTGATCTCACTAGAAA
ATGCATACTATCTTTCGGA -> TGCATACTATCTTTCGGAG
ATGCATACTTAATCAACCC -> TGCATACTTAATCAACCCT
ATGCCCAGCCCTCACATTA -> TGCCCAGCCCTCACATTAC
ATGCGGAACAGCCCGTGTC -> TGCGGAACAGCCCGTGTCT
ATGCTCCGTTTGCTCCAGG -> TGCTCCGTTTGCTCCAGGC
ATGCTGGACGCCATTCCGG -> TGCTGGACGCCATTCCGGC
ATGGATATCCTATTAAGAA -> TGGATATCCTATTAAGAAC
ATGGATTTCCGAGGGTTAG -> TGGATTTCCGAGGGTTAGC
ATGGCAAAGAGAATTATAC -> TGGCAAAGAGAATTATACG
ATGGGCGCTTGCGGAACAG -> TGGGCGCTTGCGGAACAGC
ATGGTATTGAGGCTGACGG -> TGGTATTGAGGCTGACGGA
ATGGTCGTGGGCATTACAC -> TGGTCGTGGGCATTACACA
ATGGTCGTTGAAGTCAGGA -> TGGTCGTTGAAGTCAGGAA
ATGTACTAGATATAAGTTA -> TGTACTAGATATAAGTTAA
ATGTAGCAGACGTCACGGA -> TGTAGCAGACGTCACGGAT
ATGTATGCCCAGCCCTCAC -> TGTATGCCCAGCCCTCACA
ATGTCTTGGCTAACTCAAG -> TGTCTTGGCTAACTCAAGC
ATGTGCGACCGGGTGTCCG -> TGTGCGACCGGGTGTCCGG
ATGTGCTGTGAACCGCATC -> TGTGCTGTGAACCGCATCA
ATTAAAAGGATAATCGAAT -> TTAAAAGGATAATCGAATA
ATTAAGAACCCCATCTATA -> TTAAGAACCCCATCTATAT
ATTACACAAGCTCTTTTCT -> TTACACAAGCTCTTTTCTG
ATTACATATAAAGAGCTAG -> TTACATATAAAGAGCTAGA
ATTACCACTGGGCGATACC -> TTACCACTGGGCGATACCT
ATTACTCGGAGGAGTAACG -> TTACTCGGAGGAGTAACGA
ATTAGTTACGTTGCAGTGT -> TTAGTTACGTTGCAGTGTG
ATTATACGTTATAACTAAG -> TTATACGTTATAACTAAGT
ATTATCCATGTATGCCCAG -> TTATCCATGTATGCCCAGC
ATTCACAGGCGGCCGAGTT -> TTCACAGGCGGCCGAGTTT
ATTCACCATAATTCCAAAC -> TTCACCATAATTCCAAACT
ATTCAGGCGCAATTACCAC -> TTCAGGCGCAATTACCACT
ATTCATGATACCGATAAAT -> TTCATGATACCGATAAATC
ATTCCAAACTACTTGCTTC -> TTCCAAACTACTTGCTTCG
ATTCCGGCGTGGCCATTTC -> TTCCGGCGTGGCCATTTCC
ATTCCGGCTCTGCAGACGA -> TTCCGGCTCTGCAGACGAA
ATTCCTTTGACGAACGTGG -> TTCCTTTGACGAACGTGGC
ATTCGGGGAATGGCAAAGA -> TTCGGGGAATGGCAAAGAG
ATTCGTGCATCACAATATA -> TTCGTGCATCACAATATAC
ATTCGTGTCGATTTCACGT -> TTCGTGTCGATTTCACGTA
ATTCGTTCTAAAGACTTAC -> TTCGTTCTAAAGACTTACC
ATTGAGGCTGACGGAGTAT -> TTGAGGCTGACGGAGTATG
ATTGATCTCACTAGAAAGA -> TTGATCTCACTAGAAAGAA
ATTGCGCATCGACACAGGG -> TTGCGCATCGACACAGGGG
ATTGCTCATCCACGAGTAG -> TTGCTCATCCACGAGTAGA
ATTGGAGGCCAGGCTCGCT -> TTGGAGGCCAGGCTCGCTC
ATTGGAGGCGTACTACCCT -> TTGGAGGCGTACTACCCTG
ATTGGGGCGCTACAGATCA -> TTGGGGCGCTACAGATCAG
ATTGGTTTTCGTTATAGAC -> TTGGTTTTCGTTATAGACT
ATTGTGGAGGAATCTCATG -> TTGTGGAGGAATCTCATGT
ATTTCACGTAAGAAGGTCC -> TTTCACGTAAGAAGGTCCC
ATTTCCCATCCATGTAGCA -> TTTCCCATCCATGTAGCAG
ATTTCCGAGGGTTAGCCGC -> TTTCCGAGGGTTAGCCGCT
ATTTCGCGGTGCAATATTG -> TTTCGCGGTGCAATATTGC
ATTTCGGGCACTTTTCGTA -> TTTCGGGCACTTTTCGTAG
ATTTGAGAAGCTTTGGTAT -> TTTGAGAAGCTTTGGTATG
ATTTTAGGTGCACGTAAAA -> TTTTAGGTGCACGTAAAAT
CAAAAATGAGCGACGCTTG -> AAAAATGAGCGACGCTTGG
CAAAACGCTCGGTGTCCCC -> AAAACGCTCGGTGTCCCCC
CAAACGGCAAATGAGGGGA -> AAACGGCAAATGAGGGGAC
CAAACGTAGACGTGACGGT -> AAACGTAGACGTGACGGTT
CAAACGTATAAGTCCGGCC -> AAACGTATAAGTCCGGCCA
CAAACGTGACCAACAGTAA -> AAACGTGACCAACAGTAAT
CAAACTACTTGCTTCGGAC -> AAACTACTTGCTTCGGACA
CAAAGAGAATTATACGTTA -> AAAGAGAATTATACGTTAT
CAAAGGGACGTGATTGCGC -> AAAGGGACGTGATTGCGCA
CAAATACTGTCTGAGGAGG -> AAATACTGTCTGAGGAGGG
CAAATCAGAGGGGGACGTA -> AAATCAGAGGGGGACGTAT
CAAATGAGGGGACGGGAGT -> AAATGAGGGGACGGGAGTT
CAACAACTTCACGCCAGAA -> AACAACTTCACGCCAGAAC
CAACAGTAATTCGGGGAAT -> AACAGTAATTCGGGGAATG
CAACATGAGCATGTGCTGT -> AACATGAGCATGTGCTGTG
CAACCAGGAGCCGGAACTC -> AACCAGGAGCCGGAACTCA
CAACCCTAATAACCGTGGT -> AACCCTAATAACCGTGGTC
CAACCCTTGGAGTTTATCC -> AACCCTTGGAGTTTATCCC
CAACTTCACGCCAGAACCA -> AACTTCACGCCAGAACCAG
CAAGACAATGGATTTCCGA -> AAGACAATGGATTTCCGAG
CAAGCGGAGGGGTTCAGAA -> AAGCGGAGGGGTTCAGAAC
CAAGCGGCTTGCGGCTCGG -> AAGCGGCTTGCGGCTCGGC
CAAGCTCTTTTCTGCGGGC -> AAGCTCTTTTCTGCGGGCA
CAAGGTAGATGATTGATCT -> AAGGTAGATGATTGATCTC
CAAGTGGGCTTCGGAGAAG -> AAGTGGGCTTCGGAGAAGG
CAATACGCTATAACTAATT -> AATACGCTATAACTAATTA
CAATATACGATTGGAGGCC -> AATATACGATTGGAGGCCA
CAATGAGGCGAGTGCAGTC -> AATGAGGCGAGTGCAGTCC
CAATGGATTTCCGAGGGTT -> AATGGATTTCCGAGGGTTA
CAATTACCACTGGGCGATA -> AATTACCACTGGGCGATAC
CAATTCATGATACCGATAA -> AATTCATGATACCGATAAA
CACAAAGGGACGTGATTGC -> ACAAAGGGACGTGATTGCG
CACAAGCTCTTTTCTGCGG -> ACAAGCTCTTTTCTGCGGG
CACAATATACGATTGGAGG -> ACAATATACGATTGGAGGC
CACAGCCAAACGTGACCAA -> ACAGCCAAACGTGACCAAC
CACAGGCGGCCGAGTTTAC -> ACAGGCGGCCGAGTTTACA
CACAGGGGTGACTTCGAAC -> ACAGGGGTGACTTCGAACA
CACAGTCTTCTACGGACGT -> ACAGTCTTCTACGGACGTG
CACATTACATATAAAGAGC -> ACATTACATATAAAGAGCT
CACATTTCGGGCACTTTTC -> ACATTTCGGGCACTTTTCG
CACCATAATTCCAAACTAC -> ACCATAATTCCAAACTACT
CACCGGAGCATAACTGTCA -> ACCGGAGCATAACTGTCAA
CACCGTCGATCTCATAGGA -> ACCGTCGATCTCATAGGAT
CACGAGTAGAAATCGATTC -> ACGAGTAGAAATCGATTCA
CACGCACTACGGATCATAC -> ACGCACTACGGATCATACT
CACGCCAGAACCAGCTCCC -> ACGCCAGAACCAGCTCCCT
CACGCTCGTACGCTGGAAG -> ACGCTCGTACGCTGGAAGT
CACGGATGCATACTATCTT -> ACGGATGCATACTATCTTT
CACGGCAGGGTATCGCATT -> ACGGCAGGGTATCGCATTT
CACGTAAAATCAAAACGCT -> ACGTAAAATCAAAACGCTC
CACGTAAGAAGGTCCCCGA -> ACGTAAGAAGGTCCCCGAG
CACGTCCTTAGACTGTTTT -> ACGTCCTTAGACTGTTTTT
CACTACGGATCATACTGAG -> ACTACGGATCATACTGAGC
CACTAGAAAGAAACATTTT -> ACTAGAAAGAAACATTTTA
CACTATATAATCTACGCAT -> ACTATATAATCTACGCATA
CACTATCGCCCGTCAGCGT -> ACTATCGCCCGTCAGCGTA
CACTCACCGGAGCATAACT -> ACTCACCGGAGCATAACTG
CACTGGGCGATACCTCAAC -> ACTGGGCGATACCTCAACC
CACTTGCACAGTCTTCTAC -> ACTTGCACAGTCTTCTACG
CACTTTTCGTAGGAGCAAC -> ACTTTTCGTAGGAGCAACA
CAGAACCAGCTCCCTCTGA -> AGAACCAGCTCCCTCTGAG
CAGAACGCGCGGGCTGGAT -> AGAACGCGCGGGCTGGATT
CAGAAGGTCCCCGAGGGAC -> AGAAGGTCCCCGAGGGACC
CAGAAGGTGGCGGTGAGAG -> AGAAGGTGGCGGTGAGAGC
CAGACGAAGCATTCGTGCA -> AGACGAAGCATTCGTGCAT
CAGACGTCACGGATGCATA -> AGACGTCACGGATGCATAC
CAGAGGGGGACGTATTCCG -> AGAGGGGGACGTATTCCGG
CAGATCACATTTCGGGCAC -> AGATCACATTTCGGGCACT
CAGATCAGTTAAGCCCTAA -> AGATCAGTTAAGCCCTAAC
CAGATCGCCAAACGTATAA -> AGATCGCCAAACGTATAAG
CAGCCAAACGTGACCAACA -> AGCCAAACGTGACCAACAG
CAGCCCGTGTCTTAGGGAC -> AGCCCGTGTCTTAGGGACA
CAGCCCGTGTCTTATCTGT -> AGCCCGTGTCTTATCTGTT
CAGCCCGTGTCTTCGCGGT -> AGCCCGTGTCTTCGCGGTC
CAGCCCGTGTCTTTACTGA -> AGCCCGTGTCTTTACTGAG
CAGCCCTCACATTACATAT -> AGCCCTCACATTACATATA
CAGCGTACTCGTATGCATA -> AGCGTACTCGTATGCATAC
CAGCTCCCTCTGAGCCCTG -> AGCTCCCTCTGAGCCCTGG
CAGCTCGTAGTGACCCATG -> AGCTCGTAGTGACCCATGA
CAGCTGAATCAGAAGGTCC -> AGCTGAATCAGAAGGTCCC
CAGGAAAAACACTTGCACA -> AGGAAAAACACTTGCACAG
CAGGAGCCGGAACTCAATT -> AGGAGCCGGAACTCAATTC
CAGGAGCCTTTCGCGGAAC -> AGGAGCCTTTCGCGGAACA
CAGGAGTAATACCCTTGAC -> AGGAGTAATACCCTTGACT
CAGGCAAGGTAGATGATTG -> AGGCAAGGTAGATGATTGA
CAGGCCACGCTCGTACGCT -> AGGCCACGCTCGTACGCTG
CAGGCGCAATTACCACTGG -> AGGCGCAATTACCACTGGG
CAGGCGGCCGAGTTTACAC -> AGGCGGCCGAGTTTACACA
CAGGCTAGACACCGTCGAT -> AGGCTAGACACCGTCGATC
CAGGCTCGCTCCAGAAGGT -> AGGCTCGCTCCAGAAGGTG
CAGGGGTGACTTCGAACAT -> AGGGGTGACTTCGAACATT
CAGGGTATCGCATTTGAGA -> AGGGTATCGCATTTGAGAA
CAGTAATTCCTTTGACGAA -> AGTAATTCCTTTGACGAAC
CAGTAATTCGGGGAATGGC -> AGTAATTCGGGGAATGGCA
CAGTACTATTTCGCGGTGC -> AGTACTATTTCGCGGTGCA
CAGTCCACTATATAATCTA -> AGTCCACTATATAATCTAC
CAGTCTTCTACGGACGTGA -> AGTCTTCTACGGACGTGAT
CAGTGTGGTAAGAGTAAAA -> AGTGTGGTAAGAGTAAAAA
CAGTTAAGCCCTAACTAGG -> AGTTAAGCCCTAACTAGGT
CAGTTATAGCATTGGAGGC -> AGTTATAGCATTGGAGGCG
CATAACTGTCAAATCAGAG -> ATAACTGTCAAATCAGAGG
CATAATTCCAAACTACTTG -> ATAATTCCAAACTACTTGC
CATACACTCACCGGAGCAT -> ATACACTCACCGGAGCATA
CATACCGGGCTAGCTTCGG -> ATACCGGGCTAGCTTCGGT
CATACTATCTTTCGGAGCT -> ATACTATCTTTCGGAGCTA
CATACTGAGCTGCCCTGCA -> ATACTGAGCTGCCCTGCAT
CATACTTAATCAACCCTAA -> ATACTTAATCAACCCTAAT
CATAGGATTCGTTCTAAAG -> ATAGGATTCGTTCTAAAGA
CATATAAAGAGCTAGACAG -> ATATAAAGAGCTAGACAGC
CATATGGTATTGAGGCTGA -> ATATGGTATTGAGGCTGAC
CATATTAAAAGGATAATCG -> ATATTAAAAGGATAATCGA
CATCACAATATACGATTGG -> ATCACAATATACGATTGGA
CATCACGTCCTTAGACTGT -> ATCACGTCCTTAGACTGTT
CATCCAAGACAATGGATTT -> ATCCAAGACAATGGATTTC
CATCCACGAGTAGAAATCG -> ATCCACGAGTAGAAATCGA
CATCCATGTAGCAGACGTC -> ATCCATGTAGCAGACGTCA
CATCCTCTAAGAACGTGCA -> ATCCTCTAAGAACGTGCAA
CATCCTGTCTAACATACAC -> ATCCTGTCTAACATACACT
CATCGACACAGGGGTGACT -> ATCGACACAGGGGTGACTT
CATCTATATCTGATTGGTT -> ATCTATATCTGATTGGTTT
CATGAACAGTAATTCCTTT -> ATGAACAGTAATTCCTTTG
CATGAGCATGTGCTGTGAA -> ATGAGCATGTGCTGTGAAC
CATGATACCGATAAATCCG -> ATGATACCGATAAATCCGG
CATGCTGGACGCCATTCCG -> ATGCTGGACGCCATTCCGG
CATGTACTAGATATAAGTT -> ATGTACTAGATATAAGTTA
CATGTAGCAGACGTCACGG -> ATGTAGCAGACGTCACGGA
CATGTATGCCCAGCCCTCA -> ATGTATGCCCAGCCCTCAC
CATGTGCGACCGGGTGTCC -> ATGTGCGACCGGGTGTCCG
CATGTGCTGTGAACCGCAT -> ATGTGCTGTGAACCGCATC
CATTACACAAGCTCTTTTC -> ATTACACAAGCTCTTTTCT
CATTACATATAAAGAGCTA -> ATTACATATAAAGAGCTAG
CATTAGTTACGTTGCAGTG -> ATTAGTTACGTTGCAGTGT
CATTCCGGCTCTGCAGACG -> ATTCCGGCTCTGCAGACGA
CATTCGTGCATCACAATAT -> ATTCGTGCATCACAATATA
CATTCGTGTCGATTTCACG -> ATTCGTGTCGATTTCACGT
CATTGGAGGCGTACTACCC -> ATTGGAGGCGTACTACCCT
CATTGTGGAGGAATCTCAT -> ATTGTGGAGGAATCTCATG
CATTTCCCATCCATGTAGC -> ATTTCCCATCCATGTAGCA
CATTTCGGGCACTTTTCGT -> ATTTCGGGCACTTTTCGTA
CATTTGAGAAGCTTTGGTA -> ATTTGAGAAGCTTTGGTAT
CATTTTAGGTGCACGTAAA -> ATTTTAGGTGCACGTAAAA
CCAAACGTATAAGTCCGGC -> CAAACGTATAAGTCCGGCC
CCAAACGTGACCAACAGTA -> CAAACGTGACCAACAGTAA
CCAAACTACTTGCTTCGGA -> CAAACTACTTGCTTCGGAC
CCAACAGTAATTCGGGGAA -> CAACAGTAATTCGGGGAAT
CCAAGACAATGGATTTCCG -> CAAGACAATGGATTTCCGA
CCAAGTGGGCTTCGGAGAA -> CAAGTGGGCTTCGGAGAAG
CCAATACGCTATAACTAAT -> CAATACGCTATAACTAATT
CCAATGAGGCGAGTGCAGT -> CAATGAGGCGAGTGCAGTC
CCACGAGTAGAAATCGATT -> CACGAGTAGAAATCGATTC
CCACGCTCGTACGCTGGAA -> CACGCTCGTACGCTGGAAG
CCACTATATAATCTACGCA -> CACTATATAATCTACGCAT
CCACTGGGCGATACCTCAA -> CACTGGGCGATACCTCAAC
CCAGAACCAGCTCCCTCTG -> CAGAACCAGCTCCCTCTGA
CCAGAAGGTGGCGGTGAGA -> CAGAAGGTGGCGGTGAGAG
CCAGCCCTCACATTACATA -> CAGCCCTCACATTACATAT
CCAGCTCCCTCTGAGCCCT -> CAGCTCCCTCTGAGCCCTG
CCAGGAGCCGGAACTCAAT -> CAGGAGCCGGAACTCAATT
CCAGGCAAGGTAGATGATT -> CAGGCAAGGTAGATGATTG
CCAGGCTCGCTCCAGAAGG -> CAGGCTCGCTCCAGAAGGT
CCATAATTCCAAACTACTT -> CATAATTCCAAACTACTTG
CCATCCATGTAGCAGACGT -> CATCCATGTAGCAGACGTC
CCATCTATATCTGATTGGT -> CATCTATATCTGATTGGTT
CCATGAACAGTAATTCCTT -> CATGAACAGTAATTCCTTT
CCATGTAGCAGACGTCACG -> CATGTAGCAGACGTCACGG
CCATGTATGCCCAGCCCTC -> CATGTATGCCCAGCCCTCA
CCATTCCGGCTCTGCAGAC -> CATTCCGGCTCTGCAGACG
CCATTTCCCATCCATGTAG -> CATTTCCCATCCATGTAGC
CCCAATACGCTATAACTAA -> CCAATACGCTATAACTAAT
CCCAGCCCTCACATTACAT -> CCAGCCCTCACATTACATA
CCCATCCATGTAGCAGACG -> CCATCCATGTAGCAGACGT
CCCATCTATATCTGATTGG -> CCATCTATATCTGATTGGT
CCCATGAACAGTAATTCCT -> CCATGAACAGTAATTCCTT
CCCCAATACGCTATAACTA -> CCCAATACGCTATAACTAA
CCCCATCTATATCTGATTG -> CCCATCTATATCTGATTGG
CCCCCTCGCGCTGGTGTAC -> CCCCTCGCGCTGGTGTACG
CCCCGAGGGACAGGAGCCT -> CCCGAGGGACAGGAGCCTT
CCCCGAGGGACCGGTACGT -> CCCGAGGGACCGGTACGTG
CCCCGAGGGACGCTCTTGT -> CCCGAGGGACGCTCTTGTG
CCCCGAGGGACTATGGGCG -> CCCGAGGGACTATGGGCGC
CCCCTATATCCTAATGGAT -> CCCTATATCCTAATGGATA
CCCCTCGCGCTGGTGTACG -> CCCTCGCGCTGGTGTACGA
CCCGAGGGACAGGAGCCTT -> CCGAGGGACAGGAGCCTTT
CCCGAGGGACCGGTACGTG -> CCGAGGGACCGGTACGTGA
CCCGAGGGACGCTCTTGTG -> CCGAGGGACGCTCTTGTGA
CCCGAGGGACTATGGGCGC -> CCGAGGGACTATGGGCGCT
CCCGTCAGCGTACTCGTAT -> CCGTCAGCGTACTCGTATG
CCCGTGCCCTACATTCGTG -> CCGTGCCCTACATTCGTGT
CCCGTGTCTTAGGGACATA -> CCGTGTCTTAGGGACATAT
CCCGTGTCTTATCTGTTTT -> CCGTGTCTTATCTGTTTTG
CCCGTGTCTTCGCGGTCAA -> CCGTGTCTTCGCGGTCAAG
CCCGTGTCTTTACTGAGAT -> CCGTGTCTTTACTGAGATG
CCCTAACTAGGTGACGAGG -> CCTAACTAGGTGACGAGGG
CCCTAATAACCGTGGTCTG -> CCTAATAACCGTGGTCTGC
CCCTACATTCGTGTCGATT -> CCTACATTCGTGTCGATTT
CCCTATATCCTAATGGATA -> CCTATATCCTAATGGATAT
CCCTCACATTACATATAAA -> CCTCACATTACATATAAAG
CCCTCGCGCTGGTGTACGA -> CCTCGCGCTGGTGTACGAC
CCCTCTGAGCCCTGGAAGT -> CCTCTGAGCCCTGGAAGTT
CCCTGATAAGAAAACATCC -> CCTGATAAGAAAACATCCA
CCCTGCATGCTGGACGCCA -> CCTGCATGCTGGACGCCAT
CCCTGGAAGTTGCGCCGTC -> CCTGGAAGTTGCGCCGTCA
CCCTGGCCGTATGACCTCA -> CCTGGCCGTATGACCTCAG
CCCTTGACTCACTATCGCC -> CCTTGACTCACTATCGCCC
CCCTTGGAGTTTATCCCCA -> CCTTGGAGTTTATCCCCAA
CCGAGGGACAGGAGCCTTT -> CGAGGGACAGGAGCCTTTC
CCGAGGGACCGGTACGTGA -> CGAGGGACCGGTACGTGAT
CCGAGGGACGCTCTTGTGA -> CGAGGGACGCTCTTGTGAG
CCGAGGGACTATGGGCGCT -> CGAGGGACTATGGGCGCTT
CCGAGGGTTAGCCGCTTTC -> CGAGGGTTAGCCGCTTTCT
CCGAGTTTACACAGCCAAA -> CGAGTTTACACAGCCAAAC
CCGATAAATCCGGAGCATC -> CGATAAATCCGGAGCATCC
CCGCATCACGTCCTTAGAC -> CGCATCACGTCCTTAGACT
CCGCTTTCTCAGGAGTAAT -> CGCTTTCTCAGGAGTAATA
CCGGAACTCAATTCATGAT -> CGGAACTCAATTCATGATA
CCGGACGGTCTGCGAGTCT -> CGGACGGTCTGCGAGTCTG
CCGGAGCATAACTGTCAAA -> CGGAGCATAACTGTCAAAT
CCGGAGCATCCTGTCTAAC -> CGGAGCATCCTGTCTAACA
CCGGCCAAGTGGGCTTCGG -> CGGCCAAGTGGGCTTCGGA
CCGGCGTGGCCATTTCCCA -> CGGCGTGGCCATTTCCCAT
CCGGCTCTGCAGACGAAGC -> CGGCTCTGCAGACGAAGCA
CCGGGCTAGCTTCGGTTCG -> CGGGCTAGCTTCGGTTCGA
CCGGGTGTCCGGACGGTCT -> CGGGTGTCCGGACGGTCTG
CCGGTACGTGATGCGGAAC -> CGGTACGTGATGCGGAACA
CCGTATGACCTCAGATCAC -> CGTATGACCTCAGATCACA
CCGTCAGATCGCCAAACGT -> CGTCAGATCGCCAAACGTA
CCGTCAGCGTACTCGTATG -> CGTCAGCGTACTCGTATGC
CCGTCATGTGCGACCGGGT -> CGTCATGTGCGACCGGGTG
CCGTCGATCTCATAGGATT -> CGTCGATCTCATAGGATTC
CCGTGCCCTACATTCGTGT -> CGTGCCCTACATTCGTGTC
CCGTGGTCTGCAGGCCACG -> CGTGGTCTGCAGGCCACGC
CCGTGTCTTAGGGACATAT -> CGTGTCTTAGGGACATATT
CCGTGTCTTATCTGTTTTG -> CGTGTCTTATCTGTTTTGC
CCGTGTCTTCGCGGTCAAG -> CGTGTCTTCGCGGTCAAGC
CCGTGTCTTTACTGAGATG -> CGTGTCTTTACTGAGATGG
CCGTGTTAAGATACATTAG -> CGTGTTAAGATACATTAGT
CCGTTTGCTCCAGGCAAGG -> CGTTTGCTCCAGGCAAGGT
CCTAACTAGGTGACGAGGG -> CTAACTAGGTGACGAGGGC
CCTAATAACCGTGGTCTGC -> CTAATAACCGTGGTCTGCA
CCTAATGGATATCCTATTA -> CTAATGGATATCCTATTAA
CCTACATTCGTGTCGATTT -> CTACATTCGTGTCGATTTC
CCTATATCCTAATGGATAT -> CTATATCCTAATGGATATC
CCTATTAAGAACCCCATCT -> CTATTAAGAACCCCATCTA
CCTCAACCCTTGGAGTTTA -> CTCAACCCTTGGAGTTTAT
CCTCACATTACATATAAAG -> CTCACATTACATATAAAGA
CCTCAGATCACATTTCGGG -> CTCAGATCACATTTCGGGC
CCTCCCTGGCCGTATGACC -> CTCCCTGGCCGTATGACCT
CCTCGCGCTGGTGTACGAC -> CTCGCGCTGGTGTACGACC
CCTCTAAGAACGTGCAAAT -> CTCTAAGAACGTGCAAATA
CCTCTGAGCCCTGGAAGTT -> CTCTGAGCCCTGGAAGTTG
CCTGATAAGAAAACATCCA -> CTGATAAGAAAACATCCAA
CCTGCATGCTGGACGCCAT -> CTGCATGCTGGACGCCATT
CCTGGAAGTTGCGCCGTCA -> CTGGAAGTTGCGCCGTCAG
CCTGGCCGTATGACCTCAG -> CTGGCCGTATGACCTCAGA
CCTGTCTAACATACACTCA -> CTGTCTAACATACACTCAC
CCTTAGACTGTTTTTAGCC -> CTTAGACTGTTTTTAGCCA
CCTTGACTCACTATCGCCC -> CTTGACTCACTATCGCCCG
CCTTGGAGTTTATCCCCAA -> CTTGGAGTTTATCCCCAAT
CCTTTCGCGGAACAGCCCG -> CTTTCGCGGAACAGCCCGT
CCTTTGACGAACGTGGCCT -> CTTTGACGAACGTGGCCTC
CGAACAAACGGCAAATGAG -> GAACAAACGGCAAATGAGG
CGAACATTGTGGAGGAATC -> GAACATTGTGGAGGAATCT
CGAACGTGGCCTCCCTGGC -> GAACGTGGCCTCCCTGGCC
CGAAGCATTCGTGCATCAC -> GAAGCATTCGTGCATCACA
CGAATATCGTAAAGGTGCG -> GAATATCGTAAAGGTGCGC
CGAATCGTGATTGGGGCGC -> GAATCGTGATTGGGGCGCT
CGACACAGGGGTGACTTCG -> GACACAGGGGTGACTTCGA
CGACATACCGGGCTAGCTT -> GACATACCGGGCTAGCTTC
CGACCGGGTGTCCGGACGG -> GACCGGGTGTCCGGACGGT
CGACCGTGTTAAGATACAT -> GACCGTGTTAAGATACATT
CGACGCTTGGGTACAGCTC -> GACGCTTGGGTACAGCTCG
CGAGGGACAGGAGCCTTTC -> GAGGGACAGGAGCCTTTCG
CGAGGGACCGGTACGTGAT -> GAGGGACCGGTACGTGATG
CGAGGGACGCTCTTGTGAG -> GAGGGACGCTCTTGTGAGG
CGAGGGACTATGGGCGCTT -> GAGGGACTATGGGCGCTTG
CGAGGGCTCCGTCATGTGC -> GAGGGCTCCGTCATGTGCG
CGAGGGTTAGCCGCTTTCT -> GAGGGTTAGCCGCTTTCTC
CGAGTAGAAATCGATTCAC -> GAGTAGAAATCGATTCACA
CGAGTCTGAACAAAAATGA -> GAGTCTGAACAAAAATGAG
CGAGTGCAGTCCACTATAT -> GAGTGCAGTCCACTATATA
CGAGTTTACACAGCCAAAC -> GAGTTTACACAGCCAAACG
CGATAAATCCGGAGCATCC -> GATAAATCCGGAGCATCCT
CGATACCTCAACCCTTGGA -> GATACCTCAACCCTTGGAG
CGATCTCATAGGATTCGTT -> GATCTCATAGGATTCGTTC
CGATTATCCATGTATGCCC -> GATTATCCATGTATGCCCA
CGATTCACAGGCGGCCGAG -> GATTCACAGGCGGCCGAGT
CGATTGGAGGCCAGGCTCG -> GATTGGAGGCCAGGCTCGC
CGATTTCACGTAAGAAGGT -> GATTTCACGTAAGAAGGTC
CGCAACAACTTCACGCCAG -> GCAACAACTTCACGCCAGA
CGCAATTACCACTGGGCGA -> GCAATTACCACTGGGCGAT
CGCACGGCAGGGTATCGCA -> GCACGGCAGGGTATCGCAT
CGCACTACGGATCATACTG -> GCACTACGGATCATACTGA
CGCATATGGTATTGAGGCT -> GCATATGGTATTGAGGCTG
CGCATCACGTCCTTAGACT -> GCATCACGTCCTTAGACTG
CGCATCGACACAGGGGTGA -> GCATCGACACAGGGGTGAC
CGCATTTGAGAAGCTTTGG -> GCATTTGAGAAGCTTTGGT
CGCCAAACGTATAAGTCCG -> GCCAAACGTATAAGTCCGG
CGCCAGAACCAGCTCCCTC -> GCCAGAACCAGCTCCCTCT
CGCCATTCCGGCTCTGCAG -> GCCATTCCGGCTCTGCAGA
CGCCCGTCAGCGTACTCGT -> GCCCGTCAGCGTACTCGTA
CGCCGTCAGATCGCCAAAC -> GCCGTCAGATCGCCAAACG
CGCGACATACCGGGCTAGC -> GCGACATACCGGGCTAGCT
CGCGCGGGCTGGATTCACC -> GCGCGGGCTGGATTCACCA
CGCGCTGGTGTACGACCGT -> GCGCTGGTGTACGACCGTG
CGCGGAACAGCCCGTGTCT -> GCGGAACAGCCCGTGTCTT
CGCGGGCTGGATTCACCAT -> GCGGGCTGGATTCACCATA
CGCGGTCAAGCGGCTTGCG -> GCGGTCAAGCGGCTTGCGG
CGCGGTGCAATATTGCGAT -> GCGGTGCAATATTGCGATA
CGCTACAGATCAGTTAAGC -> GCTACAGATCAGTTAAGCC
CGCTATAACTAATTACTCG -> GCTATAACTAATTACTCGG
CGCTCCAGAAGGTGGCGGT -> GCTCCAGAAGGTGGCGGTG
CGCTCGGTGTCCCCCTCGC -> GCTCGGTGTCCCCCTCGCG
CGCTCGTACGCTGGAAGTC -> GCTCGTACGCTGGAAGTCA
CGCTCTTGTGAGGCGGAAC -> GCTCTTGTGAGGCGGAACA
CGCTGGAAGTCAGTACTAT -> GCTGGAAGTCAGTACTATT
CGCTGGTGTACGACCGTGT -> GCTGGTGTACGACCGTGTT
CGCTTGCGGAACAGCCCGT -> GCTTGCGGAACAGCCCGTG
CGCTTGGGTACAGCTCGTA -> GCTTGGGTACAGCTCGTAG
CGCTTTCTCAGGAGTAATA -> GCTTTCTCAGGAGTAATAC
CGGAACAGCCCGTGTCTTA -> GGAACAGCCCGTGTCTTAG,GGAACAGCCCGTGTCTTAT
CGGAACAGCCCGTGTCTTC -> GGAACAGCCCGTGTCTTCG
CGGAACAGCCCGTGTCTTT -> GGAACAGCCCGTGTCTTTA
CGGAACTCAATTCATGATA -> GGAACTCAATTCATGATAC
CGGACAGGCTAGACACCGT -> GGACAGGCTAGACACCGTC
CGGACGGTCTGCGAGTCTG -> GGACGGTCTGCGAGTCTGA
CGGACGTGATCACGCACTA -> GGACGTGATCACGCACTAC
CGGAGAAGGTCCCCGAGGG -> GGAGAAGGTCCCCGAGGGA
CGGAGCATAACTGTCAAAT -> GGAGCATAACTGTCAAATC
CGGAGCATCCTGTCTAACA -> GGAGCATCCTGTCTAACAT
CGGAGCTAGCACAAAGGGA -> GGAGCTAGCACAAAGGGAC
CGGAGGAGTAACGAATCGT -> GGAGGAGTAACGAATCGTG
CGGAGGGGTTCAGAACGCG -> GGAGGGGTTCAGAACGCGC
CGGAGTATGGTCGTTGAAG -> GGAGTATGGTCGTTGAAGT
CGGATCATACTGAGCTGCC -> GGATCATACTGAGCTGCCC
CGGATGCATACTATCTTTC -> GGATGCATACTATCTTTCG
CGGCAAATGAGGGGACGGG -> GGCAAATGAGGGGACGGGA
CGGCAACCAGGAGCCGGAA -> GGCAACCAGGAGCCGGAAC
CGGCAGGGTATCGCATTTG -> GGCAGGGTATCGCATTTGA
CGGCCAAGTGGGCTTCGGA -> GGCCAAGTGGGCTTCGGAG
CGGCCGAGTTTACACAGCC -> GGCCGAGTTTACACAGCCA
CGGCGTGGCCATTTCCCAT -> GGCGTGGCCATTTCCCATC
CGGCTCGGCAACCAGGAGC -> GGCTCGGCAACCAGGAGCC
CGGCTCTGCAGACGAAGCA -> GGCTCTGCAGACGAAGCAT
CGGCTTGCGGCTCGGCAAC -> GGCTTGCGGCTCGGCAACC
CGGGAGTTCGCACGGCAGG -> GGGAGTTCGCACGGCAGGG
CGGGCACTTTTCGTAGGAG -> GGGCACTTTTCGTAGGAGC
CGGGCAGTTATAGCATTGG -> GGGCAGTTATAGCATTGGA
CGGGCTAGCTTCGGTTCGA -> GGGCTAGCTTCGGTTCGAA
CGGGCTGGATTCACCATAA -> GGGCTGGATTCACCATAAT
CGGGGAATGGCAAAGAGAA -> GGGGAATGGCAAAGAGAAT
CGGGTGTCCGGACGGTCTG -> GGGTGTCCGGACGGTCTGC
CGGTACGTGATGCGGAACA -> GGTACGTGATGCGGAACAG
CGGTAGCAAACGTAGACGT -> GGTAGCAAACGTAGACGTG
CGGTCAAGCGGCTTGCGGC -> GGTCAAGCGGCTTGCGGCT
CGGTCTGCGAGTCTGAACA -> GGTCTGCGAGTCTGAACAA
CGGTGAGAGCGCGACATAC -> GGTGAGAGCGCGACATACC
CGGTGCAATATTGCGATAA -> GGTGCAATATTGCGATAAA
CGGTGTCCCCCTCGCGCTG -> GGTGTCCCCCTCGCGCTGG
CGGTTATTCAGGCGCAATT -> GGTTATTCAGGCGCAATTA
CGGTTCGAACAAACGGCAA -> GGTTCGAACAAACGGCAAA
CGTAAAATCAAAACGCTCG -> GTAAAATCAAAACGCTCGG
CGTAAAGGTGCGCAACAAC -> GTAAAGGTGCGCAACAACT
CGTAAGAAGGTCCCCGAGG -> GTAAGAAGGTCCCCGAGGG
CGTACGCTGGAAGTCAGTA -> GTACGCTGGAAGTCAGTAC
CGTACTACCCTGATAAGAA -> GTACTACCCTGATAAGAAA
CGTACTCGTATGCATACTT -> GTACTCGTATGCATACTTA
CGTAGACGTGACGGTTATT -> GTAGACGTGACGGTTATTC
CGTAGGAGCAACATGAGCA -> GTAGGAGCAACATGAGCAT
CGTAGTGACCCATGAACAG -> GTAGTGACCCATGAACAGT
CGTATAAGTCCGGCCAAGT -> GTATAAGTCCGGCCAAGTG
CGTATGACCTCAGATCACA -> GTATGACCTCAGATCACAT
CGTATGCATACTTAATCAA -> GTATGCATACTTAATCAAC
CGTATTCCGGCGTGGCCAT -> GTATTCCGGCGTGGCCATT
CGTCACGGATGCATACTAT -> GTCACGGATGCATACTATC
CGTCAGATCGCCAAACGTA -> GTCAGATCGCCAAACGTAT
CGTCAGCGTACTCGTATGC -> GTCAGCGTACTCGTATGCA
CGTCATGTGCGACCGGGTG -> GTCATGTGCGACCGGGTGT
CGTCCTTAGACTGTTTTTA -> GTCCTTAGACTGTTTTTAG
CGTCGATCTCATAGGATTC -> GTCGATCTCATAGGATTCG
CGTGACCAACAGTAATTCG -> GTGACCAACAGTAATTCGG
CGTGACGGTTATTCAGGCG -> GTGACGGTTATTCAGGCGC
CGTGATCACGCACTACGGA -> GTGATCACGCACTACGGAT
CGTGATGCGGAACAGCCCG -> GTGATGCGGAACAGCCCGT
CGTGATTGCGCATCGACAC -> GTGATTGCGCATCGACACA
CGTGATTGGGGCGCTACAG -> GTGATTGGGGCGCTACAGA
CGTGCAAATACTGTCTGAG -> GTGCAAATACTGTCTGAGG
CGTGCATCACAATATACGA -> GTGCATCACAATATACGAT
CGTGCCCTACATTCGTGTC -> GTGCCCTACATTCGTGTCG
CGTGGCCATTTCCCATCCA -> GTGGCCATTTCCCATCCAT
CGTGGCCTCCCTGGCCGTA -> GTGGCCTCCCTGGCCGTAT
CGTGGGCATTACACAAGCT -> GTGGGCATTACACAAGCTC
CGTGGTCTGCAGGCCACGC -> GTGGTCTGCAGGCCACGCT
CGTGTCGATTTCACGTAAG -> GTGTCGATTTCACGTAAGA
CGTGTCTTAGGGACATATT -> GTGTCTTAGGGACATATTA
CGTGTCTTATCTGTTTTGC -> GTGTCTTATCTGTTTTGCT
CGTGTCTTCGCGGTCAAGC -> GTGTCTTCGCGGTCAAGCG
CGTGTCTTTACTGAGATGG -> GTGTCTTTACTGAGATGGT
CGTGTTAAGATACATTAGT -> GTGTTAAGATACATTAGTT
CGTTATAACTAAGTAGAAG -> GTTATAACTAAGTAGAAGG
CGTTATAGACTGTAATTGC -> GTTATAGACTGTAATTGCT
CGTTCTAAAGACTTACCCG -> GTTCTAAAGACTTACCCGT
CGTTGAAGTCAGGAAAAAC -> GTTGAAGTCAGGAAAAACA
CGTTGCAGTGTGGTAAGAG -> GTTGCAGTGTGGTAAGAGT
CGTTTGCTCCAGGCAAGGT -> GTTTGCTCCAGGCAAGGTA
CTAAAGACTTACCCGTGCC -> TAAAGACTTACCCGTGCCC
CTAACATACACTCACCGGA -> TAACATACACTCACCGGAG
CTAACTAGGTGACGAGGGC -> TAACTAGGTGACGAGGGCT
CTAACTCAAGCGGAGGGGT -> TAACTCAAGCGGAGGGGTT
CTAAGAACGTGCAAATACT -> TAAGAACGTGCAAATACTG
CTAAGTAGAAGGTCCCCGA -> TAAGTAGAAGGTCCCCGAG
CTAATAACCGTGGTCTGCA -> TAATAACCGTGGTCTGCAG
CTAATGGATATCCTATTAA -> TAATGGATATCCTATTAAG
CTAATTACTCGGAGGAGTA -> TAATTACTCGGAGGAGTAA
CTACAGATCAGTTAAGCCC -> TACAGATCAGTTAAGCCCT
CTACATTCGTGTCGATTTC -> TACATTCGTGTCGATTTCA
CTACCCTGATAAGAAAACA -> TACCCTGATAAGAAAACAT
CTACGCATATGGTATTGAG -> TACGCATATGGTATTGAGG
CTACGGACGTGATCACGCA -> TACGGACGTGATCACGCAC
CTACGGATCATACTGAGCT -> TACGGATCATACTGAGCTG
CTACTTGCTTCGGACAGGC -> TACTTGCTTCGGACAGGCT
CTAGAAAGAAACATTTTAG -> TAGAAAGAAACATTTTAGG
CTAGACACCGTCGATCTCA -> TAGACACCGTCGATCTCAT
CTAGACAGCTGAATCAGAA -> TAGACAGCTGAATCAGAAG
CTAGATATAAGTTAAGTTT -> TAGATATAAGTTAAGTTTA
CTAGCACAAAGGGACGTGA -> TAGCACAAAGGGACGTGAT
CTAGCTTCGGTTCGAACAA -> TAGCTTCGGTTCGAACAAA
CTAGGTGACGAGGGCTCCG -> TAGGTGACGAGGGCTCCGT
CTATAACTAATTACTCGGA -> TATAACTAATTACTCGGAG
CTATATAATCTACGCATAT -> TATATAATCTACGCATATG
CTATATCCTAATGGATATC -> TATATCCTAATGGATATCC
CTATATCTGATTGGTTTTC -> TATATCTGATTGGTTTTCG
CTATCGCCCGTCAGCGTAC -> TATCGCCCGTCAGCGTACT
CTATCTTTCGGAGCTAGCA -> TATCTTTCGGAGCTAGCAC
CTATGGGCGCTTGCGGAAC -> TATGGGCGCTTGCGGAACA
CTATTAAGAACCCCATCTA -> TATTAAGAACCCCATCTAT
CTATTTCGCGGTGCAATAT -> TATTTCGCGGTGCAATATT
CTCAACCCTTGGAGTTTAT -> TCAACCCTTGGAGTTTATC
CTCAAGCGGAGGGGTTCAG -> TCAAGCGGAGGGGTTCAGA
CTCAATTCATGATACCGAT -> TCAATTCATGATACCGATA
CTCACATTACATATAAAGA -> TCACATTACATATAAAGAG
CTCACCGGAGCATAACTGT -> TCACCGGAGCATAACTGTC
CTCACTAGAAAGAAACATT -> TCACTAGAAAGAAACATTT
CTCACTATCGCCCGTCAGC -> TCACTATCGCCCGTCAGCG
CTCAGATCACATTTCGGGC -> TCAGATCACATTTCGGGCA
CTCAGGAGTAATACCCTTG -> TCAGGAGTAATACCCTTGA
CTCATAGGATTCGTTCTAA -> TCATAGGATTCGTTCTAAA
CTCATCCACGAGTAGAAAT -> TCATCCACGAGTAGAAATC
CTCATGTACTAGATATAAG -> TCATGTACTAGATATAAGT
CTCCAGAAGGTGGCGGTGA -> TCCAGAAGGTGGCGGTGAG
CTCCAGGCAAGGTAGATGA -> TCCAGGCAAGGTAGATGAT
CTCCCTCTGAGCCCTGGAA -> TCCCTCTGAGCCCTGGAAG
CTCCCTGGCCGTATGACCT -> TCCCTGGCCGTATGACCTC
CTCCGTCATGTGCGACCGG -> TCCGTCATGTGCGACCGGG
CTCCGTTTGCTCCAGGCAA -> TCCGTTTGCTCCAGGCAAG
CTCGCGCTGGTGTACGACC -> TCGCGCTGGTGTACGACCG
CTCGCTCCAGAAGGTGGCG -> TCGCTCCAGAAGGTGGCGG
CTCGGAGGAGTAACGAATC -> TCGGAGGAGTAACGAATCG
CTCGGCAACCAGGAGCCGG -> TCGGCAACCAGGAGCCGGA
CTCGGTGTCCCCCTCGCGC -> TCGGTGTCCCCCTCGCGCT
CTCGTACGCTGGAAGTCAG -> TCGTACGCTGGAAGTCAGT
CTCGTAGTGACCCATGAAC -> TCGTAGTGACCCATGAACA
CTCGTATGCATACTTAATC -> TCGTATGCATACTTAATCA
CTCTAAGAACGTGCAAATA -> TCTAAGAACGTGCAAATAC
CTCTGAGCCCTGGAAGTTG -> TCTGAGCCCTGGAAGTTGC
CTCTGCAGACGAAGCATTC -> TCTGCAGACGAAGCATTCG
CTCTTGTGAGGCGGAACAG -> TCTTGTGAGGCGGAACAGC
CTCTTTTCTGCGGGCAGTT -> TCTTTTCTGCGGGCAGTTA
CTGAACAAAAATGAGCGAC -> TGAACAAAAATGAGCGACG
CTGAATCAGAAGGTCCCCG -> TGAATCAGAAGGTCCCCGA
CTGACGGAGTATGGTCGTT -> TGACGGAGTATGGTCGTTG
CTGAGATGGTCGTGGGCAT -> TGAGATGGTCGTGGGCATT
CTGAGCCCTGGAAGTTGCG -> TGAGCCCTGGAAGTTGCGC
CTGAGCTGCCCTGCATGCT -> TGAGCTGCCCTGCATGCTG
CTGAGGAGGGCCCCTATAT -> TGAGGAGGGCCCCTATATC
CTGATAAGAAAACATCCAA -> TGATAAGAAAACATCCAAG
CTGATTGGTTTTCGTTATA -> TGATTGGTTTTCGTTATAG
CTGCAGACGAAGCATTCGT -> TGCAGACGAAGCATTCGTG
CTGCAGGCCACGCTCGTAC -> TGCAGGCCACGCTCGTACG
CTGCATGCTGGACGCCATT -> TGCATGCTGGACGCCATTC
CTGCCCTGCATGCTGGACG -> TGCCCTGCATGCTGGACGC
CTGCGAGTCTGAACAAAAA -> TGCGAGTCTGAACAAAAAT
CTGCGGGCAGTTATAGCAT -> TGCGGGCAGTTATAGCATT
CTGGAAGTCAGTACTATTT -> TGGAAGTCAGTACTATTTC
CTGGAAGTTGCGCCGTCAG -> TGGAAGTTGCGCCGTCAGA
CTGGACGCCATTCCGGCTC -> TGGACGCCATTCCGGCTCT
CTGGATTCACCATAATTCC -> TGGATTCACCATAATTCCA
CTGGCCGTATGACCTCAGA -> TGGCCGTATGACCTCAGAT
CTGGGCGATACCTCAACCC -> TGGGCGATACCTCAACCCT
CTGGTGTACGACCGTGTTA -> TGGTGTACGACCGTGTTAA
CTGTAATTGCTCATCCACG -> TGTAATTGCTCATCCACGA
CTGTCAAATCAGAGGGGGA -> TGTCAAATCAGAGGGGGAC
CTGTCTAACATACACTCAC -> TGTCTAACATACACTCACC
CTGTCTGAGGAGGGCCCCT -> TGTCTGAGGAGGGCCCCTA
CTGTGAACCGCATCACGTC -> TGTGAACCGCATCACGTCC
CTGTTTTGCTTCGGTAGCA -> TGTTTTGCTTCGGTAGCAA
CTGTTTTTAGCCAATGAGG -> TGTTTTTAGCCAATGAGGC
CTTAATCAACCCTAATAAC -> TTAATCAACCCTAATAACC
CTTACCCGTGCCCTACATT -> TTACCCGTGCCCTACATTC
CTTAGACTGTTTTTAGCCA -> TTAGACTGTTTTTAGCCAA
CTTAGAGGGTTAAGTTTCA -> TTAGAGGGTTAAGTTTCAT
CTTAGGGACATATTAAAAG -> TTAGGGACATATTAAAAGG
CTTATCTGTTTTGCTTCGG -> TTATCTGTTTTGCTTCGGT
CTTCACGCCAGAACCAGCT -> TTCACGCCAGAACCAGCTC
CTTCGAACATTGTGGAGGA -> TTCGAACATTGTGGAGGAA
CTTCGCGGTCAAGCGGCTT -> TTCGCGGTCAAGCGGCTTG
CTTCGGACAGGCTAGACAC -> TTCGGACAGGCTAGACACC
CTTCGGAGAAGGTCCCCGA -> TTCGGAGAAGGTCCCCGAG
CTTCGGTAGCAAACGTAGA -> TTCGGTAGCAAACGTAGAC
CTTCGGTTCGAACAAACGG -> TTCGGTTCGAACAAACGGC
CTTCTACGGACGTGATCAC -> TTCTACGGACGTGATCACG
CTTGACTCACTATCGCCCG -> TTGACTCACTATCGCCCGT
CTTGCACAGTCTTCTACGG -> TTGCACAGTCTTCTACGGA
CTTGCGGAACAGCCCGTGT -> TTGCGGAACAGCCCGTGTC
CTTGCGGCTCGGCAACCAG -> TTGCGGCTCGGCAACCAGG
CTTGCTTCGGACAGGCTAG -> TTGCTTCGGACAGGCTAGA
CTTGGAGTTTATCCCCAAT -> TTGGAGTTTATCCCCAATA
CTTGGCTAACTCAAGCGGA -> TTGGCTAACTCAAGCGGAG
CTTGGGTACAGCTCGTAGT -> TTGGGTACAGCTCGTAGTG
CTTGTGAGGCGGAACAGCC -> TTGTGAGGCGGAACAGCCC
CTTTACTGAGATGGTCGTG -> TTTACTGAGATGGTCGTGG
CTTTCGCGGAACAGCCCGT -> TTTCGCGGAACAGCCCGTG
CTTTCGGAGCTAGCACAAA -> TTTCGGAGCTAGCACAAAG
CTTTCTCAGGAGTAATACC -> TTTCTCAGGAGTAATACCC
CTTTGACGAACGTGGCCTC -> TTTGACGAACGTGGCCTCC
CTTTGGTATGTCTTGGCTA -> TTTGGTATGTCTTGGCTAA
CTTTTCGTAGGAGCAACAT -> TTTTCGTAGGAGCAACATG
CTTTTCTGCGGGCAGTTAT -> TTTTCTGCGGGCAGTTATA
GAAAAACACTTGCACAGTC -> AAAAACACTTGCACAGTCT
GAAAACATCCAAGACAATG -> AAAACATCCAAGACAATGG
GAAACATTTTAGGTGCACG -> AAACATTTTAGGTGCACGT
GAAAGAAACATTTTAGGTG -> AAAGAAACATTTTAGGTGC
GAAATCGATTCACAGGCGG -> AAATCGATTCACAGGCGGC
GAACAAAAATGAGCGACGC -> AACAAAAATGAGCGACGCT
GAACAAACGGCAAATGAGG -> AACAAACGGCAAATGAGGG
GAACAGCCCGTGTCTTAGG -> AACAGCCCGTGTCTTAGGG
GAACAGCCCGTGTCTTATC -> AACAGCCCGTGTCTTATCT
GAACAGCCCGTGTCTTCGC -> AACAGCCCGTGTCTTCGCG
GAACAGCCCGTGTCTTTAC -> AACAGCCCGTGTCTTTACT
GAACAGTAATTCCTTTGAC -> AACAGTAATTCCTTTGACG
GAACATTGTGGAGGAATCT -> AACATTGTGGAGGAATCTC
GAACCAGCTCCCTCTGAGC -> AACCAGCTCCCTCTGAGCC
GAACCCCATCTATATCTGA -> AACCCCATCTATATCTGAT
GAACCGCATCACGTCCTTA -> AACCGCATCACGTCCTTAG
GAACGCGCGGGCTGGATTC -> AACGCGCGGGCTGGATTCA
GAACGTGCAAATACTGTCT -> AACGTGCAAATACTGTCTG
GAACGTGGCCTCCCTGGCC -> AACGTGGCCTCCCTGGCCG
GAACTCAATTCATGATACC -> AACTCAATTCATGATACCG
GAAGCATTCGTGCATCACA -> AAGCATTCGTGCATCACAA
GAAGCTTTGGTATGTCTTG -> AAGCTTTGGTATGTCTTGG
GAAGGTCCCCGAGGGACAG -> AAGGTCCCCGAGGGACAGG
GAAGGTCCCCGAGGGACCG -> AAGGTCCCCGAGGGACCGG
GAAGGTCCCCGAGGGACGC -> AAGGTCCCCGAGGGACGCT
GAAGGTCCCCGAGGGACTA -> AAGGTCCCCGAGGGACTAT
GAAGGTGGCGGTGAGAGCG -> AAGGTGGCGGTGAGAGCGC
GAAGTCAGGAAAAACACTT -> AAGTCAGGAAAAACACTTG
GAAGTCAGTACTATTTCGC -> AAGTCAGTACTATTTCGCG
GAAGTTGCGCCGTCAGATC -> AAGTTGCGCCGTCAGATCG
GAATATCGTAAAGGTGCGC -> AATATCGTAAAGGTGCGCA
GAATCAGAAGGTCCCCGAG -> AATCAGAAGGTCCCCGAGG
GAATCGTGATTGGGGCGCT -> AATCGTGATTGGGGCGCTA
GAATCTCATGTACTAGATA -> AATCTCATGTACTAGATAT
GAATGCTCCGTTTGCTCCA -> AATGCTCCGTTTGCTCCAG
GAATGGCAAAGAGAATTAT -> AATGGCAAAGAGAATTATA
GAATTATACGTTATAACTA -> AATTATACGTTATAACTAA
GACAATGGATTTCCGAGGG -> ACAATGGATTTCCGAGGGT
GACACAGGGGTGACTTCGA -> ACACAGGGGTGACTTCGAA
GACACCGTCGATCTCATAG -> ACACCGTCGATCTCATAGG
GACAGCTGAATCAGAAGGT -> ACAGCTGAATCAGAAGGTC
GACAGGAGCCTTTCGCGGA -> ACAGGAGCCTTTCGCGGAA
GACAGGCTAGACACCGTCG -> ACAGGCTAGACACCGTCGA
GACATACCGGGCTAGCTTC -> ACATACCGGGCTAGCTTCG
GACATATTAAAAGGATAAT -> ACATATTAAAAGGATAATC
GACCAACAGTAATTCGGGG -> ACCAACAGTAATTCGGGGA
GACCCATGAACAGTAATTC -> ACCCATGAACAGTAATTCC
GACCGGGTGTCCGGACGGT -> ACCGGGTGTCCGGACGGTC
GACCGGTACGTGATGCGGA -> ACCGGTACGTGATGCGGAA
GACCGTGTTAAGATACATT -> ACCGTGTTAAGATACATTA
GACCTCAGATCACATTTCG -> ACCTCAGATCACATTTCGG
GACGAACGTGGCCTCCCTG -> ACGAACGTGGCCTCCCTGG
GACGAAGCATTCGTGCATC -> ACGAAGCATTCGTGCATCA
GACGAGGGCTCCGTCATGT -> ACGAGGGCTCCGTCATGTG
GACGCCATTCCGGCTCTGC -> ACGCCATTCCGGCTCTGCA
GACGCTCTTGTGAGGCGGA -> ACGCTCTTGTGAGGCGGAA
GACGCTTGGGTACAGCTCG -> ACGCTTGGGTACAGCTCGT
GACGGAGTATGGTCGTTGA -> ACGGAGTATGGTCGTTGAA
GACGGGAGTTCGCACGGCA -> ACGGGAGTTCGCACGGCAG
GACGGTCTGCGAGTCTGAA -> ACGGTCTGCGAGTCTGAAC
GACGGTTATTCAGGCGCAA -> ACGGTTATTCAGGCGCAAT
GACGTATTCCGGCGTGGCC -> ACGTATTCCGGCGTGGCCA
GACGTCACGGATGCATACT -> ACGTCACGGATGCATACTA
GACGTGACGGTTATTCAGG -> ACGTGACGGTTATTCAGGC
GACGTGATCACGCACTACG -> ACGTGATCACGCACTACGG
GACGTGATTGCGCATCGAC -> ACGTGATTGCGCATCGACA
GACTATGGGCGCTTGCGGA -> ACTATGGGCGCTTGCGGAA
GACTCACTATCGCCCGTCA -> ACTCACTATCGCCCGTCAG
GACTGTAATTGCTCATCCA -> ACTGTAATTGCTCATCCAC
GACTGTTTTTAGCCAATGA -> ACTGTTTTTAGCCAATGAG
GACTTACCCGTGCCCTACA -> ACTTACCCGTGCCCTACAT
GACTTCGAACATTGTGGAG -> ACTTCGAACATTGTGGAGG
GAGAAGCTTTGGTATGTCT -> AGAAGCTTTGGTATGTCTT
GAGAAGGTCCCCGAGGGAC -> AGAAGGTCCCCGAGGGACG
GAGAATTATACGTTATAAC -> AGAATTATACGTTATAACT
GAGAGCGCGACATACCGGG -> AGAGCGCGACATACCGGGC
GAGATGGTCGTGGGCATTA -> AGATGGTCGTGGGCATTAC
GAGCAACATGAGCATGTGC -> AGCAACATGAGCATGTGCT
GAGCATAACTGTCAAATCA -> AGCATAACTGTCAAATCAG
GAGCATCCTGTCTAACATA -> AGCATCCTGTCTAACATAC
GAGCATGTGCTGTGAACCG -> AGCATGTGCTGTGAACCGC
GAGCCCTGGAAGTTGCGCC -> AGCCCTGGAAGTTGCGCCG
GAGCCGGAACTCAATTCAT -> AGCCGGAACTCAATTCATG
GAGCCTTTCGCGGAACAGC -> AGCCTTTCGCGGAACAGCC
GAGCGACGCTTGGGTACAG -> AGCGACGCTTGGGTACAGC
GAGCGCGACATACCGGGCT -> AGCGCGACATACCGGGCTA
GAGCTAGACAGCTGAATCA -> AGCTAGACAGCTGAATCAG
GAGCTAGCACAAAGGGACG -> AGCTAGCACAAAGGGACGT
GAGCTGCCCTGCATGCTGG -> AGCTGCCCTGCATGCTGGA
GAGGAATCTCATGTACTAG -> AGGAATCTCATGTACTAGA
GAGGAGGGCCCCTATATCC -> AGGAGGGCCCCTATATCCT
GAGGAGTAACGAATCGTGA -> AGGAGTAACGAATCGTGAT
GAGGCCAGGCTCGCTCCAG -> AGGCCAGGCTCGCTCCAGA
GAGGCGAGTGCAGTCCACT -> AGGCGAGTGCAGTCCACTA
GAGGCGGAACAGCCCGTGT -> AGGCGGAACAGCCCGTGTC
GAGGCGTACTACCCTGATA -> AGGCGTACTACCCTGATAA
GAGGCTGACGGAGTATGGT -> AGGCTGACGGAGTATGGTC
GAGGGACAGGAGCCTTTCG -> AGGGACAGGAGCCTTTCGC
GAGGGACCGGTACGTGATG -> AGGGACCGGTACGTGATGC
GAGGGACGCTCTTGTGAGG -> AGGGACGCTCTTGTGAGGC
GAGGGACTATGGGCGCTTG -> AGGGACTATGGGCGCTTGC
GAGGGCCCCTATATCCTAA -> AGGGCCCCTATATCCTAAT
GAGGGCTCCGTCATGTGCG -> AGGGCTCCGTCATGTGCGA
GAGGGGACGGGAGTTCGCA -> AGGGGACGGGAGTTCGCAC
GAGGGGGACGTATTCCGGC -> AGGGGGACGTATTCCGGCG
GAGGGGTTCAGAACGCGCG -> AGGGGTTCAGAACGCGCGG
GAGGGTTAAGTTTCATCCT -> AGGGTTAAGTTTCATCCTC
GAGGGTTAGCCGCTTTCTC -> AGGGTTAGCCGCTTTCTCA
GAGTAAAAACGATTATCCA -> AGTAAAAACGATTATCCAT
GAGTAACGAATCGTGATTG -> AGTAACGAATCGTGATTGG
GAGTAATACCCTTGACTCA -> AGTAATACCCTTGACTCAC
GAGTAGAAATCGATTCACA -> AGTAGAAATCGATTCACAG
GAGTATGGTCGTTGAAGTC -> AGTATGGTCGTTGAAGTCA
GAGTCTGAACAAAAATGAG -> AGTCTGAACAAAAATGAGC
GAGTGCAGTCCACTATATA -> AGTGCAGTCCACTATATAA
GAGTTCGCACGGCAGGGTA -> AGTTCGCACGGCAGGGTAT
GAGTTTACACAGCCAAACG -> AGTTTACACAGCCAAACGT
GAGTTTATCCCCAATACGC -> AGTTTATCCCCAATACGCT
GATAAATCCGGAGCATCCT -> ATAAATCCGGAGCATCCTG
GATAAGAAAACATCCAAGA -> ATAAGAAAACATCCAAGAC
GATAATCGAATATCGTAAA -> ATAATCGAATATCGTAAAG
GATACATTAGTTACGTTGC -> ATACATTAGTTACGTTGCA
GATACCGATAAATCCGGAG -> ATACCGATAAATCCGGAGC
GATACCTCAACCCTTGGAG -> ATACCTCAACCCTTGGAGT
GATATAAGTTAAGTTTACT -> ATATAAGTTAAGTTTACTT
GATATCCTATTAAGAACCC -> ATATCCTATTAAGAACCCC
GATCACATTTCGGGCACTT -> ATCACATTTCGGGCACTTT
GATCACGCACTACGGATCA -> ATCACGCACTACGGATCAT
GATCAGTTAAGCCCTAACT -> ATCAGTTAAGCCCTAACTA
GATCATACTGAGCTGCCCT -> ATCATACTGAGCTGCCCTG
GATCGCCAAACGTATAAGT -> ATCGCCAAACGTATAAGTC
GATCTCACTAGAAAGAAAC -> ATCTCACTAGAAAGAAACA
GATCTCATAGGATTCGTTC -> ATCTCATAGGATTCGTTCT
GATGATTGATCTCACTAGA -> ATGATTGATCTCACTAGAA
GATGCATACTATCTTTCGG -> ATGCATACTATCTTTCGGA
GATGCGGAACAGCCCGTGT -> ATGCGGAACAGCCCGTGTC
GATGGTCGTGGGCATTACA -> ATGGTCGTGGGCATTACAC
GATTATCCATGTATGCCCA -> ATTATCCATGTATGCCCAG
GATTCACAGGCGGCCGAGT -> ATTCACAGGCGGCCGAGTT
GATTCACCATAATTCCAAA -> ATTCACCATAATTCCAAAC
GATTCGTTCTAAAGACTTA -> ATTCGTTCTAAAGACTTAC
GATTGATCTCACTAGAAAG -> ATTGATCTCACTAGAAAGA
GATTGCGCATCGACACAGG -> ATTGCGCATCGACACAGGG
GATTGGAGGCCAGGCTCGC -> ATTGGAGGCCAGGCTCGCT
GATTGGGGCGCTACAGATC -> ATTGGGGCGCTACAGATCA
GATTGGTTTTCGTTATAGA -> ATTGGTTTTCGTTATAGAC
GATTTCACGTAAGAAGGTC -> ATTTCACGTAAGAAGGTCC
GATTTCCGAGGGTTAGCCG -> ATTTCCGAGGGTTAGCCGC
GCAAACGTAGACGTGACGG -> CAAACGTAGACGTGACGGT
GCAAAGAGAATTATACGTT -> CAAAGAGAATTATACGTTA
GCAAATACTGTCTGAGGAG -> CAAATACTGTCTGAGGAGG
GCAAATGAGGGGACGGGAG -> CAAATGAGGGGACGGGAGT
GCAACAACTTCACGCCAGA -> CAACAACTTCACGCCAGAA
GCAACATGAGCATGTGCTG -> CAACATGAGCATGTGCTGT
GCAACCAGGAGCCGGAACT -> CAACCAGGAGCCGGAACTC
GCAAGGTAGATGATTGATC -> CAAGGTAGATGATTGATCT
GCAATATTGCGATAAATTC -> CAATATTGCGATAAATTCG
GCAATTACCACTGGGCGAT -> CAATTACCACTGGGCGATA
GCACAAAGGGACGTGATTG -> CACAAAGGGACGTGATTGC
GCACAGTCTTCTACGGACG -> CACAGTCTTCTACGGACGT
GCACGGCAGGGTATCGCAT -> CACGGCAGGGTATCGCATT
GCACGTAAAATCAAAACGC -> CACGTAAAATCAAAACGCT
GCACTACGGATCATACTGA -> CACTACGGATCATACTGAG
GCACTTTTCGTAGGAGCAA -> CACTTTTCGTAGGAGCAAC
GCAGACGAAGCATTCGTGC -> CAGACGAAGCATTCGTGCA
GCAGACGTCACGGATGCAT -> CAGACGTCACGGATGCATA
GCAGGCCACGCTCGTACGC -> CAGGCCACGCTCGTACGCT
GCAGGGTATCGCATTTGAG -> CAGGGTATCGCATTTGAGA
GCAGTCCACTATATAATCT -> CAGTCCACTATATAATCTA
GCAGTGTGGTAAGAGTAAA -> CAGTGTGGTAAGAGTAAAA
GCAGTTATAGCATTGGAGG -> CAGTTATAGCATTGGAGGC
GCATAACTGTCAAATCAGA -> CATAACTGTCAAATCAGAG
GCATACTATCTTTCGGAGC -> CATACTATCTTTCGGAGCT
GCATACTTAATCAACCCTA -> CATACTTAATCAACCCTAA
GCATATGGTATTGAGGCTG -> CATATGGTATTGAGGCTGA
GCATCACAATATACGATTG -> CATCACAATATACGATTGG
GCATCACGTCCTTAGACTG -> CATCACGTCCTTAGACTGT
GCATCCTGTCTAACATACA -> CATCCTGTCTAACATACAC
GCATCGACACAGGGGTGAC -> CATCGACACAGGGGTGACT
GCATGCTGGACGCCATTCC -> CATGCTGGACGCCATTCCG
GCATGTGCTGTGAACCGCA -> CATGTGCTGTGAACCGCAT
GCATTACACAAGCTCTTTT -> CATTACACAAGCTCTTTTC
GCATTCGTGCATCACAATA -> CATTCGTGCATCACAATAT
GCATTGGAGGCGTACTACC -> CATTGGAGGCGTACTACCC
GCATTTGAGAAGCTTTGGT -> CATTTGAGAAGCTTTGGTA
GCCAAACGTATAAGTCCGG -> CCAAACGTATAAGTCCGGC
GCCAAACGTGACCAACAGT -> CCAAACGTGACCAACAGTA
GCCAAGTGGGCTTCGGAGA -> CCAAGTGGGCTTCGGAGAA
GCCAATGAGGCGAGTGCAG -> CCAATGAGGCGAGTGCAGT
GCCACGCTCGTACGCTGGA -> CCACGCTCGTACGCTGGAA
GCCAGAACCAGCTCCCTCT -> CCAGAACCAGCTCCCTCTG
GCCAGGCTCGCTCCAGAAG -> CCAGGCTCGCTCCAGAAGG
GCCATTCCGGCTCTGCAGA -> CCATTCCGGCTCTGCAGAC
GCCATTTCCCATCCATGTA -> CCATTTCCCATCCATGTAG
GCCCAGCCCTCACATTACA -> CCCAGCCCTCACATTACAT
GCCCCTATATCCTAATGGA -> CCCCTATATCCTAATGGAT
GCCCGTCAGCGTACTCGTA -> CCCGTCAGCGTACTCGTAT
GCCCGTGTCTTAGGGACAT -> CCCGTGTCTTAGGGACATA
GCCCGTGTCTTATCTGTTT -> CCCGTGTCTTATCTGTTTT
GCCCGTGTCTTCGCGGTCA -> CCCGTGTCTTCGCGGTCAA
GCCCGTGTCTTTACTGAGA -> CCCGTGTCTTTACTGAGAT
GCCCTAACTAGGTGACGAG -> CCCTAACTAGGTGACGAGG
GCCCTACATTCGTGTCGAT -> CCCTACATTCGTGTCGATT
GCCCTCACATTACATATAA -> CCCTCACATTACATATAAA
GCCCTGCATGCTGGACGCC -> CCCTGCATGCTGGACGCCA
GCCCTGGAAGTTGCGCCGT -> CCCTGGAAGTTGCGCCGTC
GCCGAGTTTACACAGCCAA -> CCGAGTTTACACAGCCAAA
GCCGCTTTCTCAGGAGTAA -> CCGCTTTCTCAGGAGTAAT
GCCGGAACTCAATTCATGA -> CCGGAACTCAATTCATGAT
GCCGTATGACCTCAGATCA -> CCGTATGACCTCAGATCAC
GCCGTCAGATCGCCAAACG -> CCGTCAGATCGCCAAACGT
GCCTCCCTGGCCGTATGAC -> CCTCCCTGGCCGTATGACC
GCCTTTCGCGGAACAGCCC -> CCTTTCGCGGAACAGCCCG
GCGACATACCGGGCTAGCT -> CGACATACCGGGCTAGCTT
GCGACCGGGTGTCCGGACG -> CGACCGGGTGTCCGGACGG
GCGACGCTTGGGTACAGCT -> CGACGCTTGGGTACAGCTC
GCGAGTCTGAACAAAAATG -> CGAGTCTGAACAAAAATGA
GCGAGTGCAGTCCACTATA -> CGAGTGCAGTCCACTATAT
GCGATACCTCAACCCTTGG -> CGATACCTCAACCCTTGGA
GCGCAACAACTTCACGCCA -> CGCAACAACTTCACGCCAG
GCGCAATTACCACTGGGCG -> CGCAATTACCACTGGGCGA
GCGCATCGACACAGGGGTG -> CGCATCGACACAGGGGTGA
GCGCCGTCAGATCGCCAAA -> CGCCGTCAGATCGCCAAAC
GCGCGACATACCGGGCTAG -> CGCGACATACCGGGCTAGC
GCGCGGGCTGGATTCACCA -> CGCGGGCTGGATTCACCAT
GCGCTACAGATCAGTTAAG -> CGCTACAGATCAGTTAAGC
GCGCTGGTGTACGACCGTG -> CGCTGGTGTACGACCGTGT
GCGCTTGCGGAACAGCCCG -> CGCTTGCGGAACAGCCCGT
GCGGAACAGCCCGTGTCTT -> CGGAACAGCCCGTGTCTTA,CGGAACAGCCCGTGTCTTA,CGGAACAGCCCGTGTCTTC,CGGAACAGCCCGTGTCTTT
GCGGAGGGGTTCAGAACGC -> CGGAGGGGTTCAGAACGCG
GCGGCCGAGTTTACACAGC -> CGGCCGAGTTTACACAGCC
GCGGCTCGGCAACCAGGAG -> CGGCTCGGCAACCAGGAGC
GCGGCTTGCGGCTCGGCAA -> CGGCTTGCGGCTCGGCAAC
GCGGGCAGTTATAGCATTG -> CGGGCAGTTATAGCATTGG
GCGGGCTGGATTCACCATA -> CGGGCTGGATTCACCATAA
GCGGTCAAGCGGCTTGCGG -> CGGTCAAGCGGCTTGCGGC
GCGGTGAGAGCGCGACATA -> CGGTGAGAGCGCGACATAC
GCGGTGCAATATTGCGATA -> CGGTGCAATATTGCGATAA
GCGTACTACCCTGATAAGA -> CGTACTACCCTGATAAGAA
GCGTACTCGTATGCATACT -> CGTACTCGTATGCATACTT
GCGTGGCCATTTCCCATCC -> CGTGGCCATTTCCCATCCA
GCTAACTCAAGCGGAGGGG -> CTAACTCAAGCGGAGGGGT
GCTACAGATCAGTTAAGCC -> CTACAGATCAGTTAAGCCC
GCTAGACACCGTCGATCTC -> CTAGACACCGTCGATCTCA
GCTAGACAGCTGAATCAGA -> CTAGACAGCTGAATCAGAA
GCTAGCACAAAGGGACGTG -> CTAGCACAAAGGGACGTGA
GCTAGCTTCGGTTCGAACA -> CTAGCTTCGGTTCGAACAA
GCTATAACTAATTACTCGG -> CTATAACTAATTACTCGGA
GCTCATCCACGAGTAGAAA -> CTCATCCACGAGTAGAAAT
GCTCCAGAAGGTGGCGGTG -> CTCCAGAAGGTGGCGGTGA
GCTCCAGGCAAGGTAGATG -> CTCCAGGCAAGGTAGATGA
GCTCCCTCTGAGCCCTGGA -> CTCCCTCTGAGCCCTGGAA
GCTCCGTCATGTGCGACCG -> CTCCGTCATGTGCGACCGG
GCTCCGTTTGCTCCAGGCA -> CTCCGTTTGCTCCAGGCAA
GCTCGCTCCAGAAGGTGGC -> CTCGCTCCAGAAGGTGGCG
GCTCGGCAACCAGGAGCCG -> CTCGGCAACCAGGAGCCGG
GCTCGGTGTCCCCCTCGCG -> CTCGGTGTCCCCCTCGCGC
GCTCGTACGCTGGAAGTCA -> CTCGTACGCTGGAAGTCAG
GCTCGTAGTGACCCATGAA -> CTCGTAGTGACCCATGAAC
GCTCTGCAGACGAAGCATT -> CTCTGCAGACGAAGCATTC
GCTCTTGTGAGGCGGAACA -> CTCTTGTGAGGCGGAACAG
GCTCTTTTCTGCGGGCAGT -> CTCTTTTCTGCGGGCAGTT
GCTGAATCAGAAGGTCCCC -> CTGAATCAGAAGGTCCCCG
GCTGACGGAGTATGGTCGT -> CTGACGGAGTATGGTCGTT
GCTGCCCTGCATGCTGGAC -> CTGCCCTGCATGCTGGACG
GCTGGAAGTCAGTACTATT -> CTGGAAGTCAGTACTATTT
GCTGGACGCCATTCCGGCT -> CTGGACGCCATTCCGGCTC
GCTGGATTCACCATAATTC -> CTGGATTCACCATAATTCC
GCTGGTGTACGACCGTGTT -> CTGGTGTACGACCGTGTTA
GCTGTGAACCGCATCACGT -> CTGTGAACCGCATCACGTC
GCTTCGGACAGGCTAGACA -> CTTCGGACAGGCTAGACAC
GCTTCGGAGAAGGTCCCCG -> CTTCGGAGAAGGTCCCCGA
GCTTCGGTAGCAAACGTAG -> CTTCGGTAGCAAACGTAGA
GCTTCGGTTCGAACAAACG -> CTTCGGTTCGAACAAACGG
GCTTGCGGAACAGCCCGTG -> CTTGCGGAACAGCCCGTGT
GCTTGCGGCTCGGCAACCA -> CTTGCGGCTCGGCAACCAG
GCTTGGGTACAGCTCGTAG -> CTTGGGTACAGCTCGTAGT
GCTTTCTCAGGAGTAATAC -> CTTTCTCAGGAGTAATACC
GCTTTGGTATGTCTTGGCT -> CTTTGGTATGTCTTGGCTA
GGAAAAACACTTGCACAGT -> GAAAAACACTTGCACAGTC
GGAACAGCCCGTGTCTTAG -> GAACAGCCCGTGTCTTAGG
GGAACAGCCCGTGTCTTAT -> GAACAGCCCGTGTCTTATC
GGAACAGCCCGTGTCTTCG -> GAACAGCCCGTGTCTTCGC
GGAACAGCCCGTGTCTTTA -> GAACAGCCCGTGTCTTTAC
GGAACTCAATTCATGATAC -> GAACTCAATTCATGATACC
GGAAGTCAGTACTATTTCG -> GAAGTCAGTACTATTTCGC
GGAAGTTGCGCCGTCAGAT -> GAAGTTGCGCCGTCAGATC
GGAATCTCATGTACTAGAT -> GAATCTCATGTACTAGATA
GGAATGCTCCGTTTGCTCC -> GAATGCTCCGTTTGCTCCA
GGAATGGCAAAGAGAATTA -> GAATGGCAAAGAGAATTAT
GGACAGGAGCCTTTCGCGG -> GACAGGAGCCTTTCGCGGA
GGACAGGCTAGACACCGTC -> GACAGGCTAGACACCGTCG
GGACATATTAAAAGGATAA -> GACATATTAAAAGGATAAT
GGACCGGTACGTGATGCGG -> GACCGGTACGTGATGCGGA
GGACGCCATTCCGGCTCTG -> GACGCCATTCCGGCTCTGC
GGACGCTCTTGTGAGGCGG -> GACGCTCTTGTGAGGCGGA
GGACGGGAGTTCGCACGGC -> GACGGGAGTTCGCACGGCA
GGACGGTCTGCGAGTCTGA -> GACGGTCTGCGAGTCTGAA
GGACGTATTCCGGCGTGGC -> GACGTATTCCGGCGTGGCC
GGACGTGATCACGCACTAC -> GACGTGATCACGCACTACG
GGACGTGATTGCGCATCGA -> GACGTGATTGCGCATCGAC
GGACTATGGGCGCTTGCGG -> GACTATGGGCGCTTGCGGA
GGAGAAGGTCCCCGAGGGA -> GAGAAGGTCCCCGAGGGAC
GGAGCAACATGAGCATGTG -> GAGCAACATGAGCATGTGC
GGAGCATAACTGTCAAATC -> GAGCATAACTGTCAAATCA
GGAGCATCCTGTCTAACAT -> GAGCATCCTGTCTAACATA
GGAGCCGGAACTCAATTCA -> GAGCCGGAACTCAATTCAT
GGAGCCTTTCGCGGAACAG -> GAGCCTTTCGCGGAACAGC
GGAGCTAGCACAAAGGGAC -> GAGCTAGCACAAAGGGACG
GGAGGAATCTCATGTACTA -> GAGGAATCTCATGTACTAG
GGAGGAGTAACGAATCGTG -> GAGGAGTAACGAATCGTGA
GGAGGCCAGGCTCGCTCCA -> GAGGCCAGGCTCGCTCCAG
GGAGGCGTACTACCCTGAT -> GAGGCGTACTACCCTGATA
GGAGGGCCCCTATATCCTA -> GAGGGCCCCTATATCCTAA
GGAGGGGTTCAGAACGCGC -> GAGGGGTTCAGAACGCGCG
GGAGTAACGAATCGTGATT -> GAGTAACGAATCGTGATTG
GGAGTAATACCCTTGACTC -> GAGTAATACCCTTGACTCA
GGAGTATGGTCGTTGAAGT -> GAGTATGGTCGTTGAAGTC
GGAGTTCGCACGGCAGGGT -> GAGTTCGCACGGCAGGGTA
GGAGTTTATCCCCAATACG -> GAGTTTATCCCCAATACGC
GGATAATCGAATATCGTAA -> GATAATCGAATATCGTAAA
GGATATCCTATTAAGAACC -> GATATCCTATTAAGAACCC
GGATCATACTGAGCTGCCC -> GATCATACTGAGCTGCCCT
GGATGCATACTATCTTTCG -> GATGCATACTATCTTTCGG
GGATTCACCATAATTCCAA -> GATTCACCATAATTCCAAA
GGATTCGTTCTAAAGACTT -> GATTCGTTCTAAAGACTTA
GGATTTCCGAGGGTTAGCC -> GATTTCCGAGGGTTAGCCG
GGCAAAGAGAATTATACGT -> GCAAAGAGAATTATACGTT
GGCAAATGAGGGGACGGGA -> GCAAATGAGGGGACGGGAG
GGCAACCAGGAGCCGGAAC -> GCAACCAGGAGCCGGAACT
GGCAAGGTAGATGATTGAT -> GCAAGGTAGATGATTGATC
GGCACTTTTCGTAGGAGCA -> GCACTTTTCGTAGGAGCAA
GGCAGGGTATCGCATTTGA -> GCAGGGTATCGCATTTGAG
GGCAGTTATAGCATTGGAG -> GCAGTTATAGCATTGGAGG
GGCATTACACAAGCTCTTT -> GCATTACACAAGCTCTTTT
GGCCAAGTGGGCTTCGGAG -> GCCAAGTGGGCTTCGGAGA
GGCCACGCTCGTACGCTGG -> GCCACGCTCGTACGCTGGA
GGCCAGGCTCGCTCCAGAA -> GCCAGGCTCGCTCCAGAAG
GGCCATTTCCCATCCATGT -> GCCATTTCCCATCCATGTA
GGCCCCTATATCCTAATGG -> GCCCCTATATCCTAATGGA
GGCCGAGTTTACACAGCCA -> GCCGAGTTTACACAGCCAA
GGCCGTATGACCTCAGATC -> GCCGTATGACCTCAGATCA
GGCCTCCCTGGCCGTATGA -> GCCTCCCTGGCCGTATGAC
GGCGAGTGCAGTCCACTAT -> GCGAGTGCAGTCCACTATA
GGCGATACCTCAACCCTTG -> GCGATACCTCAACCCTTGG
GGCGCAATTACCACTGGGC -> GCGCAATTACCACTGGGCG
GGCGCTACAGATCAGTTAA -> GCGCTACAGATCAGTTAAG
GGCGCTTGCGGAACAGCCC -> GCGCTTGCGGAACAGCCCG
GGCGGAACAGCCCGTGTCT -> GCGGAACAGCCCGTGTCTT
GGCGGCCGAGTTTACACAG -> GCGGCCGAGTTTACACAGC
GGCGGTGAGAGCGCGACAT -> GCGGTGAGAGCGCGACATA
GGCGTACTACCCTGATAAG -> GCGTACTACCCTGATAAGA
GGCGTGGCCATTTCCCATC -> GCGTGGCCATTTCCCATCC
GGCTAACTCAAGCGGAGGG -> GCTAACTCAAGCGGAGGGG
GGCTAGACACCGTCGATCT -> GCTAGACACCGTCGATCTC
GGCTAGCTTCGGTTCGAAC -> GCTAGCTTCGGTTCGAACA
GGCTCCGTCATGTGCGACC -> GCTCCGTCATGTGCGACCG
GGCTCGCTCCAGAAGGTGG -> GCTCGCTCCAGAAGGTGGC
GGCTCGGCAACCAGGAGCC -> GCTCGGCAACCAGGAGCCG
GGCTCTGCAGACGAAGCAT -> GCTCTGCAGACGAAGCATT
GGCTGACGGAGTATGGTCG -> GCTGACGGAGTATGGTCGT
GGCTGGATTCACCATAATT -> GCTGGATTCACCATAATTC
GGCTTCGGAGAAGGTCCCC -> GCTTCGGAGAAGGTCCCCG
GGCTTGCGGCTCGGCAACC -> GCTTGCGGCTCGGCAACCA
GGGAATGCTCCGTTTGCTC -> GGAATGCTCCGTTTGCTCC
GGGAATGGCAAAGAGAATT -> GGAATGGCAAAGAGAATTA
GGGACAGGAGCCTTTCGCG -> GGACAGGAGCCTTTCGCGG
GGGACATATTAAAAGGATA -> GGACATATTAAAAGGATAA
GGGACCGGTACGTGATGCG -> GGACCGGTACGTGATGCGG
GGGACGCTCTTGTGAGGCG -> GGACGCTCTTGTGAGGCGG
GGGACGGGAGTTCGCACGG -> GGACGGGAGTTCGCACGGC
GGGACGTATTCCGGCGTGG -> GGACGTATTCCGGCGTGGC
GGGACGTGATTGCGCATCG -> GGACGTGATTGCGCATCGA
GGGACTATGGGCGCTTGCG -> GGACTATGGGCGCTTGCGG
GGGAGTTCGCACGGCAGGG -> GGAGTTCGCACGGCAGGGT
GGGCACTTTTCGTAGGAGC -> GGCACTTTTCGTAGGAGCA
GGGCAGTTATAGCATTGGA -> GGCAGTTATAGCATTGGAG
GGGCATTACACAAGCTCTT -> GGCATTACACAAGCTCTTT
GGGCCCCTATATCCTAATG -> GGCCCCTATATCCTAATGG
GGGCGATACCTCAACCCTT -> GGCGATACCTCAACCCTTG
GGGCGCTACAGATCAGTTA -> GGCGCTACAGATCAGTTAA
GGGCGCTTGCGGAACAGCC -> GGCGCTTGCGGAACAGCCC
GGGCTAGCTTCGGTTCGAA -> GGCTAGCTTCGGTTCGAAC
GGGCTCCGTCATGTGCGAC -> GGCTCCGTCATGTGCGACC
GGGCTGGATTCACCATAAT -> GGCTGGATTCACCATAATT
GGGCTTCGGAGAAGGTCCC -> GGCTTCGGAGAAGGTCCCC
GGGGAATGCTCCGTTTGCT -> GGGAATGCTCCGTTTGCTC
GGGGAATGGCAAAGAGAAT -> GGGAATGGCAAAGAGAATT
GGGGACGGGAGTTCGCACG -> GGGACGGGAGTTCGCACGG
GGGGACGTATTCCGGCGTG -> GGGACGTATTCCGGCGTGG
GGGGCGCTACAGATCAGTT -> GGGCGCTACAGATCAGTTA
GGGGGAATGCTCCGTTTGC -> GGGGAATGCTCCGTTTGCT
GGGGGACGTATTCCGGCGT -> GGGGACGTATTCCGGCGTG
GGGGTGACTTCGAACATTG -> GGGTGACTTCGAACATTGT
GGGGTTCAGAACGCGCGGG -> GGGTTCAGAACGCGCGGGC
GGGTACAGCTCGTAGTGAC -> GGTACAGCTCGTAGTGACC
GGGTATCGCATTTGAGAAG -> GGTATCGCATTTGAGAAGC
GGGTGACTTCGAACATTGT -> GGTGACTTCGAACATTGTG
GGGTGTCCGGACGGTCTGC -> GGTGTCCGGACGGTCTGCG
GGGTTAAGTTTCATCCTCT -> GGTTAAGTTTCATCCTCTA
GGGTTAGCCGCTTTCTCAG -> GGTTAGCCGCTTTCTCAGG
GGGTTCAGAACGCGCGGGC -> GGTTCAGAACGCGCGGGCT
GGTAAGAGTAAAAACGATT -> GTAAGAGTAAAAACGATTA
GGTACAGCTCGTAGTGACC -> GTACAGCTCGTAGTGACCC
GGTACGTGATGCGGAACAG -> GTACGTGATGCGGAACAGC
GGTAGATGATTGATCTCAC -> GTAGATGATTGATCTCACT
GGTAGCAAACGTAGACGTG -> GTAGCAAACGTAGACGTGA
GGTATCGCATTTGAGAAGC -> GTATCGCATTTGAGAAGCT
GGTATGTCTTGGCTAACTC -> GTATGTCTTGGCTAACTCA
GGTATTGAGGCTGACGGAG -> GTATTGAGGCTGACGGAGT
GGTCAAGCGGCTTGCGGCT -> GTCAAGCGGCTTGCGGCTC
GGTCCCCGAGGGACAGGAG -> GTCCCCGAGGGACAGGAGC
GGTCCCCGAGGGACCGGTA -> GTCCCCGAGGGACCGGTAC
GGTCCCCGAGGGACGCTCT -> GTCCCCGAGGGACGCTCTT
GGTCCCCGAGGGACTATGG -> GTCCCCGAGGGACTATGGG
GGTCGTGGGCATTACACAA -> GTCGTGGGCATTACACAAG
GGTCGTTGAAGTCAGGAAA -> GTCGTTGAAGTCAGGAAAA
GGTCTGCAGGCCACGCTCG -> GTCTGCAGGCCACGCTCGT
GGTCTGCGAGTCTGAACAA -> GTCTGCGAGTCTGAACAAA
GGTGACGAGGGCTCCGTCA -> GTGACGAGGGCTCCGTCAT
GGTGACTTCGAACATTGTG -> GTGACTTCGAACATTGTGG
GGTGAGAGCGCGACATACC -> GTGAGAGCGCGACATACCG
GGTGCAATATTGCGATAAA -> GTGCAATATTGCGATAAAT
GGTGCACGTAAAATCAAAA -> GTGCACGTAAAATCAAAAC
GGTGCGCAACAACTTCACG -> GTGCGCAACAACTTCACGC
GGTGGCGGTGAGAGCGCGA -> GTGGCGGTGAGAGCGCGAC
GGTGTACGACCGTGTTAAG -> GTGTACGACCGTGTTAAGA
GGTGTCCCCCTCGCGCTGG -> GTGTCCCCCTCGCGCTGGT
GGTGTCCGGACGGTCTGCG -> GTGTCCGGACGGTCTGCGA
GGTTAAGTTTCATCCTCTA -> GTTAAGTTTCATCCTCTAA
GGTTAGCCGCTTTCTCAGG -> GTTAGCCGCTTTCTCAGGA
GGTTATTCAGGCGCAATTA -> GTTATTCAGGCGCAATTAC
GGTTCAGAACGCGCGGGCT -> GTTCAGAACGCGCGGGCTG
GGTTCGAACAAACGGCAAA -> GTTCGAACAAACGGCAAAT
GGTTTTCGTTATAGACTGT -> GTTTTCGTTATAGACTGTA
GTAAAAACGATTATCCATG -> TAAAAACGATTATCCATGT
GTAAAATCAAAACGCTCGG -> TAAAATCAAAACGCTCGGT
GTAAAGGTGCGCAACAACT -> TAAAGGTGCGCAACAACTT
GTAACGAATCGTGATTGGG -> TAACGAATCGTGATTGGGG
GTAAGAAGGTCCCCGAGGG -> TAAGAAGGTCCCCGAGGGA
GTAAGAGTAAAAACGATTA -> TAAGAGTAAAAACGATTAT
GTAATACCCTTGACTCACT -> TAATACCCTTGACTCACTA
GTAATTCCTTTGACGAACG -> TAATTCCTTTGACGAACGT
GTAATTCGGGGAATGGCAA -> TAATTCGGGGAATGGCAAA
GTAATTGCTCATCCACGAG -> TAATTGCTCATCCACGAGT
GTACAGCTCGTAGTGACCC -> TACAGCTCGTAGTGACCCA
GTACGACCGTGTTAAGATA -> TACGACCGTGTTAAGATAC
GTACGCTGGAAGTCAGTAC -> TACGCTGGAAGTCAGTACT
GTACGTGATGCGGAACAGC -> TACGTGATGCGGAACAGCC
GTACTACCCTGATAAGAAA -> TACTACCCTGATAAGAAAA
GTACTAGATATAAGTTAAG -> TACTAGATATAAGTTAAGT
GTACTATTTCGCGGTGCAA -> TACTATTTCGCGGTGCAAT
GTACTCGTATGCATACTTA -> TACTCGTATGCATACTTAA
GTAGAAATCGATTCACAGG -> TAGAAATCGATTCACAGGC
GTAGAAGGTCCCCGAGGGA -> TAGAAGGTCCCCGAGGGAC
GTAGACGTGACGGTTATTC -> TAGACGTGACGGTTATTCA
GTAGATGATTGATCTCACT -> TAGATGATTGATCTCACTA
GTAGCAAACGTAGACGTGA -> TAGCAAACGTAGACGTGAC
GTAGCAGACGTCACGGATG -> TAGCAGACGTCACGGATGC
GTAGGAGCAACATGAGCAT -> TAGGAGCAACATGAGCATG
GTAGTGACCCATGAACAGT -> TAGTGACCCATGAACAGTA
GTATAAGTCCGGCCAAGTG -> TATAAGTCCGGCCAAGTGG
GTATCGCATTTGAGAAGCT -> TATCGCATTTGAGAAGCTT
GTATGACCTCAGATCACAT -> TATGACCTCAGATCACATT
GTATGCATACTTAATCAAC -> TATGCATACTTAATCAACC
GTATGCCCAGCCCTCACAT -> TATGCCCAGCCCTCACATT
GTATGGTCGTTGAAGTCAG -> TATGGTCGTTGAAGTCAGG
GTATGTCTTGGCTAACTCA -> TATGTCTTGGCTAACTCAA
GTATTCCGGCGTGGCCATT -> TATTCCGGCGTGGCCATTT
GTATTGAGGCTGACGGAGT -> TATTGAGGCTGACGGAGTA
GTCAAATCAGAGGGGGACG -> TCAAATCAGAGGGGGACGT
GTCAAGCGGCTTGCGGCTC -> TCAAGCGGCTTGCGGCTCG
GTCACGGATGCATACTATC -> TCACGGATGCATACTATCT
GTCAGATCGCCAAACGTAT -> TCAGATCGCCAAACGTATA
GTCAGCGTACTCGTATGCA -> TCAGCGTACTCGTATGCAT
GTCAGGAAAAACACTTGCA -> TCAGGAAAAACACTTGCAC
GTCAGTACTATTTCGCGGT -> TCAGTACTATTTCGCGGTG
GTCATGTGCGACCGGGTGT -> TCATGTGCGACCGGGTGTC
GTCCACTATATAATCTACG -> TCCACTATATAATCTACGC
GTCCCCCTCGCGCTGGTGT -> TCCCCCTCGCGCTGGTGTA
GTCCCCGAGGGACAGGAGC -> TCCCCGAGGGACAGGAGCC
GTCCCCGAGGGACCGGTAC -> TCCCCGAGGGACCGGTACG
GTCCCCGAGGGACGCTCTT -> TCCCCGAGGGACGCTCTTG
GTCCCCGAGGGACTATGGG -> TCCCCGAGGGACTATGGGC
GTCCGGACGGTCTGCGAGT -> TCCGGACGGTCTGCGAGTC
GTCCGGCCAAGTGGGCTTC -> TCCGGCCAAGTGGGCTTCG
GTCCTTAGACTGTTTTTAG -> TCCTTAGACTGTTTTTAGC
GTCGATCTCATAGGATTCG -> TCGATCTCATAGGATTCGT
GTCGATTTCACGTAAGAAG -> TCGATTTCACGTAAGAAGG
GTCGTGGGCATTACACAAG -> TCGTGGGCATTACACAAGC
GTCGTTGAAGTCAGGAAAA -> TCGTTGAAGTCAGGAAAAA
GTCTAACATACACTCACCG -> TCTAACATACACTCACCGG
GTCTGAACAAAAATGAGCG -> TCTGAACAAAAATGAGCGA
GTCTGAGGAGGGCCCCTAT -> TCTGAGGAGGGCCCCTATA
GTCTGCAGGCCACGCTCGT -> TCTGCAGGCCACGCTCGTA
GTCTGCGAGTCTGAACAAA -> TCTGCGAGTCTGAACAAAA
GTCTTAGGGACATATTAAA -> TCTTAGGGACATATTAAAA
GTCTTATCTGTTTTGCTTC -> TCTTATCTGTTTTGCTTCG
GTCTTCGCGGTCAAGCGGC -> TCTTCGCGGTCAAGCGGCT
GTCTTCTACGGACGTGATC -> TCTTCTACGGACGTGATCA
GTCTTGGCTAACTCAAGCG -> TCTTGGCTAACTCAAGCGG
GTCTTTACTGAGATGGTCG -> TCTTTACTGAGATGGTCGT
GTGAACCGCATCACGTCCT -> TGAACCGCATCACGTCCTT
GTGACCAACAGTAATTCGG -> TGACCAACAGTAATTCGGG
GTGACCCATGAACAGTAAT -> TGACCCATGAACAGTAATT
GTGACGAGGGCTCCGTCAT -> TGACGAGGGCTCCGTCATG
GTGACGGTTATTCAGGCGC -> TGACGGTTATTCAGGCGCA
GTGACTTCGAACATTGTGG -> TGACTTCGAACATTGTGGA
GTGAGAGCGCGACATACCG -> TGAGAGCGCGACATACCGG
GTGAGGCGGAACAGCCCGT -> TGAGGCGGAACAGCCCGTG
GTGATCACGCACTACGGAT -> TGATCACGCACTACGGATC
GTGATGCGGAACAGCCCGT -> TGATGCGGAACAGCCCGTG
GTGATTGCGCATCGACACA -> TGATTGCGCATCGACACAG
GTGATTGGGGCGCTACAGA -> TGATTGGGGCGCTACAGAT
GTGCAAATACTGTCTGAGG -> TGCAAATACTGTCTGAGGA
GTGCAATATTGCGATAAAT -> TGCAATATTGCGATAAATT
GTGCACGTAAAATCAAAAC -> TGCACGTAAAATCAAAACG
GTGCAGTCCACTATATAAT -> TGCAGTCCACTATATAATC
GTGCATCACAATATACGAT -> TGCATCACAATATACGATT
GTGCCCTACATTCGTGTCG -> TGCCCTACATTCGTGTCGA
GTGCGACCGGGTGTCCGGA -> TGCGACCGGGTGTCCGGAC
GTGCGCAACAACTTCACGC -> TGCGCAACAACTTCACGCC
GTGCTGTGAACCGCATCAC -> TGCTGTGAACCGCATCACG
GTGGAGGAATCTCATGTAC -> TGGAGGAATCTCATGTACT
GTGGCCATTTCCCATCCAT -> TGGCCATTTCCCATCCATG
GTGGCCTCCCTGGCCGTAT -> TGGCCTCCCTGGCCGTATG
GTGGCGGTGAGAGCGCGAC -> TGGCGGTGAGAGCGCGACA
GTGGGCATTACACAAGCTC -> TGGGCATTACACAAGCTCT
GTGGGCTTCGGAGAAGGTC -> TGGGCTTCGGAGAAGGTCC
GTGGTAAGAGTAAAAACGA -> TGGTAAGAGTAAAAACGAT
GTGGTCTGCAGGCCACGCT -> TGGTCTGCAGGCCACGCTC
GTGTACGACCGTGTTAAGA -> TGTACGACCGTGTTAAGAT
GTGTCCCCCTCGCGCTGGT -> TGTCCCCCTCGCGCTGGTG
GTGTCCGGACGGTCTGCGA -> TGTCCGGACGGTCTGCGAG
GTGTCGATTTCACGTAAGA -> TGTCGATTTCACGTAAGAA
GTGTCTTAGGGACATATTA -> TGTCTTAGGGACATATTAA
GTGTCTTATCTGTTTTGCT -> TGTCTTATCTGTTTTGCTT
GTGTCTTCGCGGTCAAGCG -> TGTCTTCGCGGTCAAGCGG
GTGTCTTTACTGAGATGGT -> TGTCTTTACTGAGATGGTC
GTGTGGTAAGAGTAAAAAC -> TGTGGTAAGAGTAAAAACG
GTGTTAAGATACATTAGTT -> TGTTAAGATACATTAGTTA
GTTAAGATACATTAGTTAC -> TTAAGATACATTAGTTACG
GTTAAGCCCTAACTAGGTG -> TTAAGCCCTAACTAGGTGA
GTTAAGTTTACTTAGAGGG -> TTAAGTTTACTTAGAGGGT
GTTAAGTTTCATCCTCTAA -> TTAAGTTTCATCCTCTAAG
GTTACGTTGCAGTGTGGTA -> TTACGTTGCAGTGTGGTAA
GTTAGCCGCTTTCTCAGGA -> TTAGCCGCTTTCTCAGGAG
GTTATAACTAAGTAGAAGG -> TTATAACTAAGTAGAAGGT
GTTATAGACTGTAATTGCT -> TTATAGACTGTAATTGCTC
GTTATAGCATTGGAGGCGT -> TTATAGCATTGGAGGCGTA
GTTATTCAGGCGCAATTAC -> TTATTCAGGCGCAATTACC
GTTCAGAACGCGCGGGCTG -> TTCAGAACGCGCGGGCTGG
GTTCGAACAAACGGCAAAT -> TTCGAACAAACGGCAAATG
GTTCGCACGGCAGGGTATC -> TTCGCACGGCAGGGTATCG
GTTCTAAAGACTTACCCGT -> TTCTAAAGACTTACCCGTG
GTTGAAGTCAGGAAAAACA -> TTGAAGTCAGGAAAAACAC
GTTGCAGTGTGGTAAGAGT -> TTGCAGTGTGGTAAGAGTA
GTTGCGCCGTCAGATCGCC -> TTGCGCCGTCAGATCGCCA
GTTTACACAGCCAAACGTG -> TTTACACAGCCAAACGTGA
GTTTACTTAGAGGGTTAAG -> TTTACTTAGAGGGTTAAGT
GTTTATCCCCAATACGCTA -> TTTATCCCCAATACGCTAT
GTTTCATCCTCTAAGAACG -> TTTCATCCTCTAAGAACGT
GTTTGCTCCAGGCAAGGTA -> TTTGCTCCAGGCAAGGTAG
GTTTTCGTTATAGACTGTA -> TTTTCGTTATAGACTGTAA
GTTTTGCTTCGGTAGCAAA -> TTTTGCTTCGGTAGCAAAC
GTTTTTAGCCAATGAGGCG -> TTTTTAGCCAATGAGGCGA
TAAAAACGATTATCCATGT -> AAAAACGATTATCCATGTA
TAAAAGGATAATCGAATAT -> AAAAGGATAATCGAATATC
TAAAATCAAAACGCTCGGT -> AAAATCAAAACGCTCGGTG
TAAAGACTTACCCGTGCCC -> AAAGACTTACCCGTGCCCT
TAAAGAGCTAGACAGCTGA -> AAAGAGCTAGACAGCTGAA
TAAAGGTGCGCAACAACTT -> AAAGGTGCGCAACAACTTC
TAAATCCGGAGCATCCTGT -> AAATCCGGAGCATCCTGTC
TAACATACACTCACCGGAG -> AACATACACTCACCGGAGC
TAACCGTGGTCTGCAGGCC -> AACCGTGGTCTGCAGGCCA
TAACGAATCGTGATTGGGG -> AACGAATCGTGATTGGGGC
TAACTAAGTAGAAGGTCCC -> AACTAAGTAGAAGGTCCCC
TAACTAATTACTCGGAGGA -> AACTAATTACTCGGAGGAG
TAACTAGGTGACGAGGGCT -> AACTAGGTGACGAGGGCTC
TAACTCAAGCGGAGGGGTT -> AACTCAAGCGGAGGGGTTC
TAACTGTCAAATCAGAGGG -> AACTGTCAAATCAGAGGGG
TAAGAAAACATCCAAGACA -> AAGAAAACATCCAAGACAA
TAAGAACCCCATCTATATC -> AAGAACCCCATCTATATCT
TAAGAACGTGCAAATACTG -> AAGAACGTGCAAATACTGT
TAAGAAGGTCCCCGAGGGA -> AAGAAGGTCCCCGAGGGAC
TAAGAGTAAAAACGATTAT -> AAGAGTAAAAACGATTATC
TAAGATACATTAGTTACGT -> AAGATACATTAGTTACGTT
TAAGCCCTAACTAGGTGAC -> AAGCCCTAACTAGGTGACG
TAAGTAGAAGGTCCCCGAG -> AAGTAGAAGGTCCCCGAGG
TAAGTCCGGCCAAGTGGGC -> AAGTCCGGCCAAGTGGGCT
TAAGTTAAGTTTACTTAGA -> AAGTTAAGTTTACTTAGAG
TAAGTTTACTTAGAGGGTT -> AAGTTTACTTAGAGGGTTA
TAAGTTTCATCCTCTAAGA -> AAGTTTCATCCTCTAAGAA
TAATAACCGTGGTCTGCAG -> AATAACCGTGGTCTGCAGG
TAATACCCTTGACTCACTA -> AATACCCTTGACTCACTAT
TAATCAACCCTAATAACCG -> AATCAACCCTAATAACCGT
TAATCGAATATCGTAAAGG -> AATCGAATATCGTAAAGGT
TAATCTACGCATATGGTAT -> AATCTACGCATATGGTATT
TAATGGATATCCTATTAAG -> AATGGATATCCTATTAAGA
TAATTACTCGGAGGAGTAA -> AATTACTCGGAGGAGTAAC
TAATTCCAAACTACTTGCT -> AATTCCAAACTACTTGCTT
TAATTCCTTTGACGAACGT -> AATTCCTTTGACGAACGTG
TAATTCGGGGAATGGCAAA -> AATTCGGGGAATGGCAAAG
TAATTGCTCATCCACGAGT -> AATTGCTCATCCACGAGTA
TACACAAGCTCTTTTCTGC -> ACACAAGCTCTTTTCTGCG
TACACAGCCAAACGTGACC -> ACACAGCCAAACGTGACCA
TACACTCACCGGAGCATAA -> ACACTCACCGGAGCATAAC
TACAGATCAGTTAAGCCCT -> ACAGATCAGTTAAGCCCTA
TACAGCTCGTAGTGACCCA -> ACAGCTCGTAGTGACCCAT
TACATATAAAGAGCTAGAC -> ACATATAAAGAGCTAGACA
TACATTAGTTACGTTGCAG -> ACATTAGTTACGTTGCAGT
TACATTCGTGTCGATTTCA -> ACATTCGTGTCGATTTCAC
TACCACTGGGCGATACCTC -> ACCACTGGGCGATACCTCA
TACCCGTGCCCTACATTCG -> ACCCGTGCCCTACATTCGT
TACCCTGATAAGAAAACAT -> ACCCTGATAAGAAAACATC
TACCCTTGACTCACTATCG -> ACCCTTGACTCACTATCGC
TACCGATAAATCCGGAGCA -> ACCGATAAATCCGGAGCAT
TACCGGGCTAGCTTCGGTT -> ACCGGGCTAGCTTCGGTTC
TACCTCAACCCTTGGAGTT -> ACCTCAACCCTTGGAGTTT
TACGACCGTGTTAAGATAC -> ACGACCGTGTTAAGATACA
TACGATTGGAGGCCAGGCT -> ACGATTGGAGGCCAGGCTC
TACGCATATGGTATTGAGG -> ACGCATATGGTATTGAGGC
TACGCTATAACTAATTACT -> ACGCTATAACTAATTACTC
TACGCTGGAAGTCAGTACT -> ACGCTGGAAGTCAGTACTA
TACGGACGTGATCACGCAC -> ACGGACGTGATCACGCACT
TACGGATCATACTGAGCTG -> ACGGATCATACTGAGCTGC
TACGTGATGCGGAACAGCC -> ACGTGATGCGGAACAGCCC
TACGTTATAACTAAGTAGA -> ACGTTATAACTAAGTAGAA
TACGTTGCAGTGTGGTAAG -> ACGTTGCAGTGTGGTAAGA
TACTACCCTGATAAGAAAA -> ACTACCCTGATAAGAAAAC
TACTAGATATAAGTTAAGT -> ACTAGATATAAGTTAAGTT
TACTATCTTTCGGAGCTAG -> ACTATCTTTCGGAGCTAGC
TACTATTTCGCGGTGCAAT -> ACTATTTCGCGGTGCAATA
TACTCGGAGGAGTAACGAA -> ACTCGGAGGAGTAACGAAT
TACTCGTATGCATACTTAA -> ACTCGTATGCATACTTAAT
TACTGAGATGGTCGTGGGC -> ACTGAGATGGTCGTGGGCA
TACTGAGCTGCCCTGCATG -> ACTGAGCTGCCCTGCATGC
TACTGTCTGAGGAGGGCCC -> ACTGTCTGAGGAGGGCCCC
TACTTAATCAACCCTAATA -> ACTTAATCAACCCTAATAA
TACTTAGAGGGTTAAGTTT -> ACTTAGAGGGTTAAGTTTC
TACTTGCTTCGGACAGGCT -> ACTTGCTTCGGACAGGCTA
TAGAAAGAAACATTTTAGG -> AGAAAGAAACATTTTAGGT
TAGAAATCGATTCACAGGC -> AGAAATCGATTCACAGGCG
TAGAAGGTCCCCGAGGGAC -> AGAAGGTCCCCGAGGGACT
TAGACACCGTCGATCTCAT -> AGACACCGTCGATCTCATA
TAGACAGCTGAATCAGAAG -> AGACAGCTGAATCAGAAGG
TAGACGTGACGGTTATTCA -> AGACGTGACGGTTATTCAG
TAGACTGTAATTGCTCATC -> AGACTGTAATTGCTCATCC
TAGACTGTTTTTAGCCAAT -> AGACTGTTTTTAGCCAATG
TAGAGGGTTAAGTTTCATC -> AGAGGGTTAAGTTTCATCC
TAGATATAAGTTAAGTTTA -> AGATATAAGTTAAGTTTAC
TAGATGATTGATCTCACTA -> AGATGATTGATCTCACTAG
TAGCAAACGTAGACGTGAC -> AGCAAACGTAGACGTGACG
TAGCACAAAGGGACGTGAT -> AGCACAAAGGGACGTGATT
TAGCAGACGTCACGGATGC -> AGCAGACGTCACGGATGCA
TAGCATTGGAGGCGTACTA -> AGCATTGGAGGCGTACTAC
TAGCCAATGAGGCGAGTGC -> AGCCAATGAGGCGAGTGCA
TAGCCGCTTTCTCAGGAGT -> AGCCGCTTTCTCAGGAGTA
TAGCTTCGGTTCGAACAAA -> AGCTTCGGTTCGAACAAAC
TAGGAGCAACATGAGCATG -> AGGAGCAACATGAGCATGT
TAGGATTCGTTCTAAAGAC -> AGGATTCGTTCTAAAGACT
TAGGGACATATTAAAAGGA -> AGGGACATATTAAAAGGAT
TAGGTGACGAGGGCTCCGT -> AGGTGACGAGGGCTCCGTC
TAGGTGCACGTAAAATCAA -> AGGTGCACGTAAAATCAAA
TAGTGACCCATGAACAGTA -> AGTGACCCATGAACAGTAA
TAGTTACGTTGCAGTGTGG -> AGTTACGTTGCAGTGTGGT
TATAAAGAGCTAGACAGCT -> ATAAAGAGCTAGACAGCTG
TATAACTAAGTAGAAGGTC -> ATAACTAAGTAGAAGGTCC
TATAACTAATTACTCGGAG -> ATAACTAATTACTCGGAGG
TATAAGTCCGGCCAAGTGG -> ATAAGTCCGGCCAAGTGGG
TATAAGTTAAGTTTACTTA -> ATAAGTTAAGTTTACTTAG
TATAATCTACGCATATGGT -> ATAATCTACGCATATGGTA
TATACGATTGGAGGCCAGG -> ATACGATTGGAGGCCAGGC
TATACGTTATAACTAAGTA -> ATACGTTATAACTAAGTAG
TATAGACTGTAATTGCTCA -> ATAGACTGTAATTGCTCAT
TATAGCATTGGAGGCGTAC -> ATAGCATTGGAGGCGTACT
TATATAATCTACGCATATG -> ATATAATCTACGCATATGG
TATATCCTAATGGATATCC -> ATATCCTAATGGATATCCT
TATATCTGATTGGTTTTCG -> ATATCTGATTGGTTTTCGT
TATCCATGTATGCCCAGCC -> ATCCATGTATGCCCAGCCC
TATCCCCAATACGCTATAA -> ATCCCCAATACGCTATAAC
TATCCTAATGGATATCCTA -> ATCCTAATGGATATCCTAT
TATCCTATTAAGAACCCCA -> ATCCTATTAAGAACCCCAT
TATCGCATTTGAGAAGCTT -> ATCGCATTTGAGAAGCTTT
TATCGCCCGTCAGCGTACT -> ATCGCCCGTCAGCGTACTC
TATCGTAAAGGTGCGCAAC -> ATCGTAAAGGTGCGCAACA
TATCTGATTGGTTTTCGTT -> ATCTGATTGGTTTTCGTTA
TATCTGTTTTGCTTCGGTA -> ATCTGTTTTGCTTCGGTAG
TATCTTTCGGAGCTAGCAC -> ATCTTTCGGAGCTAGCACA
TATGACCTCAGATCACATT -> ATGACCTCAGATCACATTT
TATGCATACTTAATCAACC -> ATGCATACTTAATCAACCC
TATGCCCAGCCCTCACATT -> ATGCCCAGCCCTCACATTA
TATGGGCGCTTGCGGAACA -> ATGGGCGCTTGCGGAACAG
TATGGTATTGAGGCTGACG -> ATGGTATTGAGGCTGACGG
TATGGTCGTTGAAGTCAGG -> ATGGTCGTTGAAGTCAGGA
TATGTCTTGGCTAACTCAA -> ATGTCTTGGCTAACTCAAG
TATTAAAAGGATAATCGAA -> ATTAAAAGGATAATCGAAT
TATTAAGAACCCCATCTAT -> ATTAAGAACCCCATCTATA
TATTCAGGCGCAATTACCA -> ATTCAGGCGCAATTACCAC
TATTCCGGCGTGGCCATTT -> ATTCCGGCGTGGCCATTTC
TATTGAGGCTGACGGAGTA -> ATTGAGGCTGACGGAGTAT
TATTTCGCGGTGCAATATT -> ATTTCGCGGTGCAATATTG
TCAAAACGCTCGGTGTCCC -> CAAAACGCTCGGTGTCCCC
TCAAATCAGAGGGGGACGT -> CAAATCAGAGGGGGACGTA
TCAACCCTAATAACCGTGG -> CAACCCTAATAACCGTGGT
TCAACCCTTGGAGTTTATC -> CAACCCTTGGAGTTTATCC
TCAAGCGGAGGGGTTCAGA -> CAAGCGGAGGGGTTCAGAA
TCAAGCGGCTTGCGGCTCG -> CAAGCGGCTTGCGGCTCGG
TCAATTCATGATACCGATA -> CAATTCATGATACCGATAA
TCACAATATACGATTGGAG -> CACAATATACGATTGGAGG
TCACAGGCGGCCGAGTTTA -> CACAGGCGGCCGAGTTTAC
TCACATTACATATAAAGAG -> CACATTACATATAAAGAGC
TCACATTTCGGGCACTTTT -> CACATTTCGGGCACTTTTC
TCACCATAATTCCAAACTA -> CACCATAATTCCAAACTAC
TCACCGGAGCATAACTGTC -> CACCGGAGCATAACTGTCA
TCACGCACTACGGATCATA -> CACGCACTACGGATCATAC
TCACGCCAGAACCAGCTCC -> CACGCCAGAACCAGCTCCC
TCACGGATGCATACTATCT -> CACGGATGCATACTATCTT
TCACGTAAGAAGGTCCCCG -> CACGTAAGAAGGTCCCCGA
TCACGTCCTTAGACTGTTT -> CACGTCCTTAGACTGTTTT
TCACTAGAAAGAAACATTT -> CACTAGAAAGAAACATTTT
TCACTATCGCCCGTCAGCG -> CACTATCGCCCGTCAGCGT
TCAGAACGCGCGGGCTGGA -> CAGAACGCGCGGGCTGGAT
TCAGAAGGTCCCCGAGGGA -> CAGAAGGTCCCCGAGGGAC
TCAGAGGGGGACGTATTCC -> CAGAGGGGGACGTATTCCG
TCAGATCACATTTCGGGCA -> CAGATCACATTTCGGGCAC
TCAGATCGCCAAACGTATA -> CAGATCGCCAAACGTATAA
TCAGCGTACTCGTATGCAT -> CAGCGTACTCGTATGCATA
TCAGGAAAAACACTTGCAC -> CAGGAAAAACACTTGCACA
TCAGGAGTAATACCCTTGA -> CAGGAGTAATACCCTTGAC
TCAGGCGCAATTACCACTG -> CAGGCGCAATTACCACTGG
TCAGTACTATTTCGCGGTG -> CAGTACTATTTCGCGGTGC
TCAGTTAAGCCCTAACTAG -> CAGTTAAGCCCTAACTAGG
TCATACTGAGCTGCCCTGC -> CATACTGAGCTGCCCTGCA
TCATAGGATTCGTTCTAAA -> CATAGGATTCGTTCTAAAG
TCATCCACGAGTAGAAATC -> CATCCACGAGTAGAAATCG
TCATCCTCTAAGAACGTGC -> CATCCTCTAAGAACGTGCA
TCATGATACCGATAAATCC -> CATGATACCGATAAATCCG
TCATGTACTAGATATAAGT -> CATGTACTAGATATAAGTT
TCATGTGCGACCGGGTGTC -> CATGTGCGACCGGGTGTCC
TCCAAACTACTTGCTTCGG -> CCAAACTACTTGCTTCGGA
TCCAAGACAATGGATTTCC -> CCAAGACAATGGATTTCCG
TCCACGAGTAGAAATCGAT -> CCACGAGTAGAAATCGATT
TCCACTATATAATCTACGC -> CCACTATATAATCTACGCA
TCCAGAAGGTGGCGGTGAG -> CCAGAAGGTGGCGGTGAGA
TCCAGGCAAGGTAGATGAT -> CCAGGCAAGGTAGATGATT
TCCATGTAGCAGACGTCAC -> CCATGTAGCAGACGTCACG
TCCATGTATGCCCAGCCCT -> CCATGTATGCCCAGCCCTC
TCCCATCCATGTAGCAGAC -> CCCATCCATGTAGCAGACG
TCCCCAATACGCTATAACT -> CCCCAATACGCTATAACTA
TCCCCCTCGCGCTGGTGTA -> CCCCCTCGCGCTGGTGTAC
TCCCCGAGGGACAGGAGCC -> CCCCGAGGGACAGGAGCCT
TCCCCGAGGGACCGGTACG -> CCCCGAGGGACCGGTACGT
TCCCCGAGGGACGCTCTTG -> CCCCGAGGGACGCTCTTGT
TCCCCGAGGGACTATGGGC -> CCCCGAGGGACTATGGGCG
TCCCTCTGAGCCCTGGAAG -> CCCTCTGAGCCCTGGAAGT
TCCCTGGCCGTATGACCTC -> CCCTGGCCGTATGACCTCA
TCCGAGGGTTAGCCGCTTT -> CCGAGGGTTAGCCGCTTTC
TCCGGACGGTCTGCGAGTC -> CCGGACGGTCTGCGAGTCT
TCCGGAGCATCCTGTCTAA -> CCGGAGCATCCTGTCTAAC
TCCGGCCAAGTGGGCTTCG -> CCGGCCAAGTGGGCTTCGG
TCCGGCGTGGCCATTTCCC -> CCGGCGTGGCCATTTCCCA
TCCGGCTCTGCAGACGAAG -> CCGGCTCTGCAGACGAAGC
TCCGTCATGTGCGACCGGG -> CCGTCATGTGCGACCGGGT
TCCGTTTGCTCCAGGCAAG -> CCGTTTGCTCCAGGCAAGG
TCCTAATGGATATCCTATT -> CCTAATGGATATCCTATTA
TCCTATTAAGAACCCCATC -> CCTATTAAGAACCCCATCT
TCCTCTAAGAACGTGCAAA -> CCTCTAAGAACGTGCAAAT
TCCTGTCTAACATACACTC -> CCTGTCTAACATACACTCA
TCCTTAGACTGTTTTTAGC -> CCTTAGACTGTTTTTAGCC
TCCTTTGACGAACGTGGCC -> CCTTTGACGAACGTGGCCT
TCGAACAAACGGCAAATGA -> CGAACAAACGGCAAATGAG
TCGAACATTGTGGAGGAAT -> CGAACATTGTGGAGGAATC
TCGAATATCGTAAAGGTGC -> CGAATATCGTAAAGGTGCG
TCGACACAGGGGTGACTTC -> CGACACAGGGGTGACTTCG
TCGATCTCATAGGATTCGT -> CGATCTCATAGGATTCGTT
TCGATTCACAGGCGGCCGA -> CGATTCACAGGCGGCCGAG
TCGATTTCACGTAAGAAGG -> CGATTTCACGTAAGAAGGT
TCGCACGGCAGGGTATCGC -> CGCACGGCAGGGTATCGCA
TCGCATTTGAGAAGCTTTG -> CGCATTTGAGAAGCTTTGG
TCGCCAAACGTATAAGTCC -> CGCCAAACGTATAAGTCCG
TCGCCCGTCAGCGTACTCG -> CGCCCGTCAGCGTACTCGT
TCGCGCTGGTGTACGACCG -> CGCGCTGGTGTACGACCGT
TCGCGGAACAGCCCGTGTC -> CGCGGAACAGCCCGTGTCT
TCGCGGTCAAGCGGCTTGC -> CGCGGTCAAGCGGCTTGCG
TCGCGGTGCAATATTGCGA -> CGCGGTGCAATATTGCGAT
TCGCTCCAGAAGGTGGCGG -> CGCTCCAGAAGGTGGCGGT
TCGGACAGGCTAGACACCG -> CGGACAGGCTAGACACCGT
TCGGAGAAGGTCCCCGAGG -> CGGAGAAGGTCCCCGAGGG
TCGGAGCTAGCACAAAGGG -> CGGAGCTAGCACAAAGGGA
TCGGAGGAGTAACGAATCG -> CGGAGGAGTAACGAATCGT
TCGGCAACCAGGAGCCGGA -> CGGCAACCAGGAGCCGGAA
TCGGGCACTTTTCGTAGGA -> CGGGCACTTTTCGTAGGAG
TCGGGGAATGGCAAAGAGA -> CGGGGAATGGCAAAGAGAA
TCGGTAGCAAACGTAGACG -> CGGTAGCAAACGTAGACGT
TCGGTGTCCCCCTCGCGCT -> CGGTGTCCCCCTCGCGCTG
TCGGTTCGAACAAACGGCA -> CGGTTCGAACAAACGGCAA
TCGTAAAGGTGCGCAACAA -> CGTAAAGGTGCGCAACAAC
TCGTACGCTGGAAGTCAGT -> CGTACGCTGGAAGTCAGTA
TCGTAGGAGCAACATGAGC -> CGTAGGAGCAACATGAGCA
TCGTAGTGACCCATGAACA -> CGTAGTGACCCATGAACAG
TCGTATGCATACTTAATCA -> CGTATGCATACTTAATCAA
TCGTGATTGGGGCGCTACA -> CGTGATTGGGGCGCTACAG
TCGTGCATCACAATATACG -> CGTGCATCACAATATACGA
TCGTGGGCATTACACAAGC -> CGTGGGCATTACACAAGCT
TCGTGTCGATTTCACGTAA -> CGTGTCGATTTCACGTAAG
TCGTTATAGACTGTAATTG -> CGTTATAGACTGTAATTGC
TCGTTCTAAAGACTTACCC -> CGTTCTAAAGACTTACCCG
TCGTTGAAGTCAGGAAAAA -> CGTTGAAGTCAGGAAAAAC
TCTAAAGACTTACCCGTGC -> CTAAAGACTTACCCGTGCC
TCTAACATACACTCACCGG -> CTAACATACACTCACCGGA
TCTAAGAACGTGCAAATAC -> CTAAGAACGTGCAAATACT
TCTACGCATATGGTATTGA -> CTACGCATATGGTATTGAG
TCTACGGACGTGATCACGC -> CTACGGACGTGATCACGCA
TCTATATCTGATTGGTTTT -> CTATATCTGATTGGTTTTC
TCTCACTAGAAAGAAACAT -> CTCACTAGAAAGAAACATT
TCTCAGGAGTAATACCCTT -> CTCAGGAGTAATACCCTTG
TCTCATAGGATTCGTTCTA -> CTCATAGGATTCGTTCTAA
TCTCATGTACTAGATATAA -> CTCATGTACTAGATATAAG
TCTGAACAAAAATGAGCGA -> CTGAACAAAAATGAGCGAC
TCTGAGCCCTGGAAGTTGC -> CTGAGCCCTGGAAGTTGCG
TCTGAGGAGGGCCCCTATA -> CTGAGGAGGGCCCCTATAT
TCTGATTGGTTTTCGTTAT -> CTGATTGGTTTTCGTTATA
TCTGCAGACGAAGCATTCG -> CTGCAGACGAAGCATTCGT
TCTGCAGGCCACGCTCGTA -> CTGCAGGCCACGCTCGTAC
TCTGCGAGTCTGAACAAAA -> CTGCGAGTCTGAACAAAAA
TCTGCGGGCAGTTATAGCA -> CTGCGGGCAGTTATAGCAT
TCTGTTTTGCTTCGGTAGC -> CTGTTTTGCTTCGGTAGCA
TCTTAGGGACATATTAAAA -> CTTAGGGACATATTAAAAG
TCTTATCTGTTTTGCTTCG -> CTTATCTGTTTTGCTTCGG
TCTTCGCGGTCAAGCGGCT -> CTTCGCGGTCAAGCGGCTT
TCTTCTACGGACGTGATCA -> CTTCTACGGACGTGATCAC
TCTTGGCTAACTCAAGCGG -> CTTGGCTAACTCAAGCGGA
TCTTGTGAGGCGGAACAGC -> CTTGTGAGGCGGAACAGCC
TCTTTACTGAGATGGTCGT -> CTTTACTGAGATGGTCGTG
TCTTTCGGAGCTAGCACAA -> CTTTCGGAGCTAGCACAAA
TCTTTTCTGCGGGCAGTTA -> CTTTTCTGCGGGCAGTTAT
TGAACAAAAATGAGCGACG -> GAACAAAAATGAGCGACGC
TGAACAGTAATTCCTTTGA -> GAACAGTAATTCCTTTGAC
TGAACCGCATCACGTCCTT -> GAACCGCATCACGTCCTTA
TGAAGTCAGGAAAAACACT -> GAAGTCAGGAAAAACACTT
TGAATCAGAAGGTCCCCGA -> GAATCAGAAGGTCCCCGAG
TGACCAACAGTAATTCGGG -> GACCAACAGTAATTCGGGG
TGACCCATGAACAGTAATT -> GACCCATGAACAGTAATTC
TGACCTCAGATCACATTTC -> GACCTCAGATCACATTTCG
TGACGAACGTGGCCTCCCT -> GACGAACGTGGCCTCCCTG
TGACGAGGGCTCCGTCATG -> GACGAGGGCTCCGTCATGT
TGACGGAGTATGGTCGTTG -> GACGGAGTATGGTCGTTGA
TGACGGTTATTCAGGCGCA -> GACGGTTATTCAGGCGCAA
TGACTCACTATCGCCCGTC -> GACTCACTATCGCCCGTCA
TGACTTCGAACATTGTGGA -> GACTTCGAACATTGTGGAG
TGAGAAGCTTTGGTATGTC -> GAGAAGCTTTGGTATGTCT
TGAGAGCGCGACATACCGG -> GAGAGCGCGACATACCGGG
TGAGATGGTCGTGGGCATT -> GAGATGGTCGTGGGCATTA
TGAGCATGTGCTGTGAACC -> GAGCATGTGCTGTGAACCG
TGAGCCCTGGAAGTTGCGC -> GAGCCCTGGAAGTTGCGCC
TGAGCGACGCTTGGGTACA -> GAGCGACGCTTGGGTACAG
TGAGCTGCCCTGCATGCTG -> GAGCTGCCCTGCATGCTGG
TGAGGAGGGCCCCTATATC -> GAGGAGGGCCCCTATATCC
TGAGGCGAGTGCAGTCCAC -> GAGGCGAGTGCAGTCCACT
TGAGGCGGAACAGCCCGTG -> GAGGCGGAACAGCCCGTGT
TGAGGCTGACGGAGTATGG -> GAGGCTGACGGAGTATGGT
TGAGGGGACGGGAGTTCGC -> GAGGGGACGGGAGTTCGCA
TGATAAGAAAACATCCAAG -> GATAAGAAAACATCCAAGA
TGATACCGATAAATCCGGA -> GATACCGATAAATCCGGAG
TGATCACGCACTACGGATC -> GATCACGCACTACGGATCA
TGATCTCACTAGAAAGAAA -> GATCTCACTAGAAAGAAAC
TGATGCGGAACAGCCCGTG -> GATGCGGAACAGCCCGTGT
TGATTGATCTCACTAGAAA -> GATTGATCTCACTAGAAAG
TGATTGCGCATCGACACAG -> GATTGCGCATCGACACAGG
TGATTGGGGCGCTACAGAT -> GATTGGGGCGCTACAGATC
TGATTGGTTTTCGTTATAG -> GATTGGTTTTCGTTATAGA
TGCAAATACTGTCTGAGGA -> GCAAATACTGTCTGAGGAG
TGCAATATTGCGATAAATT -> GCAATATTGCGATAAATTC
TGCACAGTCTTCTACGGAC -> GCACAGTCTTCTACGGACG
TGCACGTAAAATCAAAACG -> GCACGTAAAATCAAAACGC
TGCAGACGAAGCATTCGTG -> GCAGACGAAGCATTCGTGC
TGCAGGCCACGCTCGTACG -> GCAGGCCACGCTCGTACGC
TGCAGTCCACTATATAATC -> GCAGTCCACTATATAATCT
TGCAGTGTGGTAAGAGTAA -> GCAGTGTGGTAAGAGTAAA
TGCATACTATCTTTCGGAG -> GCATACTATCTTTCGGAGC
TGCATACTTAATCAACCCT -> GCATACTTAATCAACCCTA
TGCATCACAATATACGATT -> GCATCACAATATACGATTG
TGCATGCTGGACGCCATTC -> GCATGCTGGACGCCATTCC
TGCCCAGCCCTCACATTAC -> GCCCAGCCCTCACATTACA
TGCCCTACATTCGTGTCGA -> GCCCTACATTCGTGTCGAT
TGCCCTGCATGCTGGACGC -> GCCCTGCATGCTGGACGCC
TGCGACCGGGTGTCCGGAC -> GCGACCGGGTGTCCGGACG
TGCGAGTCTGAACAAAAAT -> GCGAGTCTGAACAAAAATG
TGCGCAACAACTTCACGCC -> GCGCAACAACTTCACGCCA
TGCGCATCGACACAGGGGT -> GCGCATCGACACAGGGGTG
TGCGCCGTCAGATCGCCAA -> GCGCCGTCAGATCGCCAAA
TGCGGAACAGCCCGTGTCT -> GCGGAACAGCCCGTGTCTT,GCGGAACAGCCCGTGTCTT
TGCGGCTCGGCAACCAGGA -> GCGGCTCGGCAACCAGGAG
TGCGGGCAGTTATAGCATT -> GCGGGCAGTTATAGCATTG
TGCTCATCCACGAGTAGAA -> GCTCATCCACGAGTAGAAA
TGCTCCAGGCAAGGTAGAT -> GCTCCAGGCAAGGTAGATG
TGCTCCGTTTGCTCCAGGC -> GCTCCGTTTGCTCCAGGCA
TGCTGGACGCCATTCCGGC -> GCTGGACGCCATTCCGGCT
TGCTGTGAACCGCATCACG -> GCTGTGAACCGCATCACGT
TGCTTCGGACAGGCTAGAC -> GCTTCGGACAGGCTAGACA
TGCTTCGGTAGCAAACGTA -> GCTTCGGTAGCAAACGTAG
TGGAAGTCAGTACTATTTC -> GGAAGTCAGTACTATTTCG
TGGAAGTTGCGCCGTCAGA -> GGAAGTTGCGCCGTCAGAT
TGGACGCCATTCCGGCTCT -> GGACGCCATTCCGGCTCTG
TGGAGGAATCTCATGTACT -> GGAGGAATCTCATGTACTA
TGGAGGCCAGGCTCGCTCC -> GGAGGCCAGGCTCGCTCCA
TGGAGGCGTACTACCCTGA -> GGAGGCGTACTACCCTGAT
TGGAGTTTATCCCCAATAC -> GGAGTTTATCCCCAATACG
TGGATATCCTATTAAGAAC -> GGATATCCTATTAAGAACC
TGGATTCACCATAATTCCA -> GGATTCACCATAATTCCAA
TGGATTTCCGAGGGTTAGC -> GGATTTCCGAGGGTTAGCC
TGGCAAAGAGAATTATACG -> GGCAAAGAGAATTATACGT
TGGCCATTTCCCATCCATG -> GGCCATTTCCCATCCATGT
TGGCCGTATGACCTCAGAT -> GGCCGTATGACCTCAGATC
TGGCCTCCCTGGCCGTATG -> GGCCTCCCTGGCCGTATGA
TGGCGGTGAGAGCGCGACA -> GGCGGTGAGAGCGCGACAT
TGGCTAACTCAAGCGGAGG -> GGCTAACTCAAGCGGAGGG
TGGGCATTACACAAGCTCT -> GGGCATTACACAAGCTCTT
TGGGCGATACCTCAACCCT -> GGGCGATACCTCAACCCTT
TGGGCGCTTGCGGAACAGC -> GGGCGCTTGCGGAACAGCC
TGGGCTTCGGAGAAGGTCC -> GGGCTTCGGAGAAGGTCCC
TGGGGCGCTACAGATCAGT -> GGGGCGCTACAGATCAGTT
TGGGTACAGCTCGTAGTGA -> GGGTACAGCTCGTAGTGAC
TGGTAAGAGTAAAAACGAT -> GGTAAGAGTAAAAACGATT
TGGTATGTCTTGGCTAACT -> GGTATGTCTTGGCTAACTC
TGGTATTGAGGCTGACGGA -> GGTATTGAGGCTGACGGAG
TGGTCGTGGGCATTACACA -> GGTCGTGGGCATTACACAA
TGGTCGTTGAAGTCAGGAA -> GGTCGTTGAAGTCAGGAAA
TGGTCTGCAGGCCACGCTC -> GGTCTGCAGGCCACGCTCG
TGGTGTACGACCGTGTTAA -> GGTGTACGACCGTGTTAAG
TGGTTTTCGTTATAGACTG -> GGTTTTCGTTATAGACTGT
TGTAATTGCTCATCCACGA -> GTAATTGCTCATCCACGAG
TGTACGACCGTGTTAAGAT -> GTACGACCGTGTTAAGATA
TGTACTAGATATAAGTTAA -> GTACTAGATATAAGTTAAG
TGTAGCAGACGTCACGGAT -> GTAGCAGACGTCACGGATG
TGTATGCCCAGCCCTCACA -> GTATGCCCAGCCCTCACAT
TGTCAAATCAGAGGGGGAC -> GTCAAATCAGAGGGGGACG
TGTCCCCCTCGCGCTGGTG -> GTCCCCCTCGCGCTGGTGT
TGTCCGGACGGTCTGCGAG -> GTCCGGACGGTCTGCGAGT
TGTCGATTTCACGTAAGAA -> GTCGATTTCACGTAAGAAG
TGTCTAACATACACTCACC -> GTCTAACATACACTCACCG
TGTCTGAGGAGGGCCCCTA -> GTCTGAGGAGGGCCCCTAT
TGTCTTAGGGACATATTAA -> GTCTTAGGGACATATTAAA
TGTCTTATCTGTTTTGCTT -> GTCTTATCTGTTTTGCTTC
TGTCTTCGCGGTCAAGCGG -> GTCTTCGCGGTCAAGCGGC
TGTCTTGGCTAACTCAAGC -> GTCTTGGCTAACTCAAGCG
TGTCTTTACTGAGATGGTC -> GTCTTTACTGAGATGGTCG
TGTGAACCGCATCACGTCC -> GTGAACCGCATCACGTCCT
TGTGAGGCGGAACAGCCCG -> GTGAGGCGGAACAGCCCGT
TGTGCGACCGGGTGTCCGG -> GTGCGACCGGGTGTCCGGA
TGTGCTGTGAACCGCATCA -> GTGCTGTGAACCGCATCAC
TGTGGAGGAATCTCATGTA -> GTGGAGGAATCTCATGTAC
TGTGGTAAGAGTAAAAACG -> GTGGTAAGAGTAAAAACGA
TGTTAAGATACATTAGTTA -> GTTAAGATACATTAGTTAC
TGTTTTGCTTCGGTAGCAA -> GTTTTGCTTCGGTAGCAAA
TGTTTTTAGCCAATGAGGC -> GTTTTTAGCCAATGAGGCG
TTAAAAGGATAATCGAATA -> TAAAAGGATAATCGAATAT
TTAAGAACCCCATCTATAT -> TAAGAACCCCATCTATATC
TTAAGATACATTAGTTACG -> TAAGATACATTAGTTACGT
TTAAGCCCTAACTAGGTGA -> TAAGCCCTAACTAGGTGAC
TTAAGTTTACTTAGAGGGT -> TAAGTTTACTTAGAGGGTT
TTAAGTTTCATCCTCTAAG -> TAAGTTTCATCCTCTAAGA
TTAATCAACCCTAATAACC -> TAATCAACCCTAATAACCG
TTACACAAGCTCTTTTCTG -> TACACAAGCTCTTTTCTGC
TTACACAGCCAAACGTGAC -> TACACAGCCAAACGTGACC
TTACATATAAAGAGCTAGA -> TACATATAAAGAGCTAGAC
TTACCACTGGGCGATACCT -> TACCACTGGGCGATACCTC
TTACCCGTGCCCTACATTC -> TACCCGTGCCCTACATTCG
TTACGTTGCAGTGTGGTAA -> TACGTTGCAGTGTGGTAAG
TTACTCGGAGGAGTAACGA -> TACTCGGAGGAGTAACGAA
TTACTGAGATGGTCGTGGG -> TACTGAGATGGTCGTGGGC
TTACTTAGAGGGTTAAGTT -> TACTTAGAGGGTTAAGTTT
TTAGACTGTTTTTAGCCAA -> TAGACTGTTTTTAGCCAAT
TTAGAGGGTTAAGTTTCAT -> TAGAGGGTTAAGTTTCATC
TTAGCCAATGAGGCGAGTG -> TAGCCAATGAGGCGAGTGC
TTAGCCGCTTTCTCAGGAG -> TAGCCGCTTTCTCAGGAGT
TTAGGGACATATTAAAAGG -> TAGGGACATATTAAAAGGA
TTAGGTGCACGTAAAATCA -> TAGGTGCACGTAAAATCAA
TTAGTTACGTTGCAGTGTG -> TAGTTACGTTGCAGTGTGG
TTATAACTAAGTAGAAGGT -> TATAACTAAGTAGAAGGTC
TTATACGTTATAACTAAGT -> TATACGTTATAACTAAGTA
TTATAGACTGTAATTGCTC -> TATAGACTGTAATTGCTCA
TTATAGCATTGGAGGCGTA -> TATAGCATTGGAGGCGTAC
TTATCCATGTATGCCCAGC -> TATCCATGTATGCCCAGCC
TTATCCCCAATACGCTATA -> TATCCCCAATACGCTATAA
TTATCTGTTTTGCTTCGGT -> TATCTGTTTTGCTTCGGTA
TTATTCAGGCGCAATTACC -> TATTCAGGCGCAATTACCA
TTCACAGGCGGCCGAGTTT -> TCACAGGCGGCCGAGTTTA
TTCACCATAATTCCAAACT -> TCACCATAATTCCAAACTA
TTCACGCCAGAACCAGCTC -> TCACGCCAGAACCAGCTCC
TTCACGTAAGAAGGTCCCC -> TCACGTAAGAAGGTCCCCG
TTCAGAACGCGCGGGCTGG -> TCAGAACGCGCGGGCTGGA
TTCAGGCGCAATTACCACT -> TCAGGCGCAATTACCACTG
TTCATCCTCTAAGAACGTG -> TCATCCTCTAAGAACGTGC
TTCATGATACCGATAAATC -> TCATGATACCGATAAATCC
TTCCAAACTACTTGCTTCG -> TCCAAACTACTTGCTTCGG
TTCCCATCCATGTAGCAGA -> TCCCATCCATGTAGCAGAC
TTCCGAGGGTTAGCCGCTT -> TCCGAGGGTTAGCCGCTTT
TTCCGGCGTGGCCATTTCC -> TCCGGCGTGGCCATTTCCC
TTCCGGCTCTGCAGACGAA -> TCCGGCTCTGCAGACGAAG
TTCCTTTGACGAACGTGGC -> TCCTTTGACGAACGTGGCC
TTCGAACAAACGGCAAATG -> TCGAACAAACGGCAAATGA
TTCGAACATTGTGGAGGAA -> TCGAACATTGTGGAGGAAT
TTCGCACGGCAGGGTATCG -> TCGCACGGCAGGGTATCGC
TTCGCGGAACAGCCCGTGT -> TCGCGGAACAGCCCGTGTC
TTCGCGGTCAAGCGGCTTG -> TCGCGGTCAAGCGGCTTGC
TTCGCGGTGCAATATTGCG -> TCGCGGTGCAATATTGCGA
TTCGGACAGGCTAGACACC -> TCGGACAGGCTAGACACCG
TTCGGAGAAGGTCCCCGAG -> TCGGAGAAGGTCCCCGAGG
TTCGGAGCTAGCACAAAGG -> TCGGAGCTAGCACAAAGGG
TTCGGGCACTTTTCGTAGG -> TCGGGCACTTTTCGTAGGA
TTCGGGGAATGGCAAAGAG -> TCGGGGAATGGCAAAGAGA
TTCGGTAGCAAACGTAGAC -> TCGGTAGCAAACGTAGACG
TTCGGTTCGAACAAACGGC -> TCGGTTCGAACAAACGGCA
TTCGTAGGAGCAACATGAG -> TCGTAGGAGCAACATGAGC
TTCGTGCATCACAATATAC -> TCGTGCATCACAATATACG
TTCGTGTCGATTTCACGTA -> TCGTGTCGATTTCACGTAA
TTCGTTATAGACTGTAATT -> TCGTTATAGACTGTAATTG
TTCGTTCTAAAGACTTACC -> TCGTTCTAAAGACTTACCC
TTCTAAAGACTTACCCGTG -> TCTAAAGACTTACCCGTGC
TTCTACGGACGTGATCACG -> TCTACGGACGTGATCACGC
TTCTCAGGAGTAATACCCT -> TCTCAGGAGTAATACCCTT
TTCTGCGGGCAGTTATAGC -> TCTGCGGGCAGTTATAGCA
TTGAAGTCAGGAAAAACAC -> TGAAGTCAGGAAAAACACT
TTGACGAACGTGGCCTCCC -> TGACGAACGTGGCCTCCCT
TTGACTCACTATCGCCCGT -> TGACTCACTATCGCCCGTC
TTGAGAAGCTTTGGTATGT -> TGAGAAGCTTTGGTATGTC
TTGAGGCTGACGGAGTATG -> TGAGGCTGACGGAGTATGG
TTGATCTCACTAGAAAGAA -> TGATCTCACTAGAAAGAAA
TTGCACAGTCTTCTACGGA -> TGCACAGTCTTCTACGGAC
TTGCAGTGTGGTAAGAGTA -> TGCAGTGTGGTAAGAGTAA
TTGCGCATCGACACAGGGG -> TGCGCATCGACACAGGGGT
TTGCGCCGTCAGATCGCCA -> TGCGCCGTCAGATCGCCAA
TTGCGGAACAGCCCGTGTC -> TGCGGAACAGCCCGTGTCT
TTGCGGCTCGGCAACCAGG -> TGCGGCTCGGCAACCAGGA
TTGCTCATCCACGAGTAGA -> TGCTCATCCACGAGTAGAA
TTGCTCCAGGCAAGGTAGA -> TGCTCCAGGCAAGGTAGAT
TTGCTTCGGACAGGCTAGA -> TGCTTCGGACAGGCTAGAC
TTGCTTCGGTAGCAAACGT -> TGCTTCGGTAGCAAACGTA
TTGGAGGCCAGGCTCGCTC -> TGGAGGCCAGGCTCGCTCC
TTGGAGGCGTACTACCCTG -> TGGAGGCGTACTACCCTGA
TTGGAGTTTATCCCCAATA -> TGGAGTTTATCCCCAATAC
TTGGCTAACTCAAGCGGAG -> TGGCTAACTCAAGCGGAGG
TTGGGGCGCTACAGATCAG -> TGGGGCGCTACAGATCAGT
TTGGGTACAGCTCGTAGTG -> TGGGTACAGCTCGTAGTGA
TTGGTATGTCTTGGCTAAC -> TGGTATGTCTTGGCTAACT
TTGGTTTTCGTTATAGACT -> TGGTTTTCGTTATAGACTG
TTGTGAGGCGGAACAGCCC -> TGTGAGGCGGAACAGCCCG
TTGTGGAGGAATCTCATGT -> TGTGGAGGAATCTCATGTA
TTTACACAGCCAAACGTGA -> TTACACAGCCAAACGTGAC
TTTACTGAGATGGTCGTGG -> TTACTGAGATGGTCGTGGG
TTTACTTAGAGGGTTAAGT -> TTACTTAGAGGGTTAAGTT
TTTAGCCAATGAGGCGAGT -> TTAGCCAATGAGGCGAGTG
TTTAGGTGCACGTAAAATC -> TTAGGTGCACGTAAAATCA
TTTATCCCCAATACGCTAT -> TTATCCCCAATACGCTATA
TTTCACGTAAGAAGGTCCC -> TTCACGTAAGAAGGTCCCC
TTTCATCCTCTAAGAACGT -> TTCATCCTCTAAGAACGTG
TTTCCCATCCATGTAGCAG -> TTCCCATCCATGTAGCAGA
TTTCCGAGGGTTAGCCGCT -> TTCCGAGGGTTAGCCGCTT
TTTCGCGGAACAGCCCGTG -> TTCGCGGAACAGCCCGTGT
TTTCGCGGTGCAATATTGC -> TTCGCGGTGCAATATTGCG
TTTCGGAGCTAGCACAAAG -> TTCGGAGCTAGCACAAAGG
TTTCGGGCACTTTTCGTAG -> TTCGGGCACTTTTCGTAGG
TTTCGTAGGAGCAACATGA -> TTCGTAGGAGCAACATGAG
TTTCGTTATAGACTGTAAT -> TTCGTTATAGACTGTAATT
TTTCTCAGGAGTAATACCC -> TTCTCAGGAGTAATACCCT
TTTCTGCGGGCAGTTATAG -> TTCTGCGGGCAGTTATAGC
TTTGACGAACGTGGCCTCC -> TTGACGAACGTGGCCTCCC
TTTGAGAAGCTTTGGTATG -> TTGAGAAGCTTTGGTATGT
TTTGCTCCAGGCAAGGTAG -> TTGCTCCAGGCAAGGTAGA
TTTGCTTCGGTAGCAAACG -> TTGCTTCGGTAGCAAACGT
TTTGGTATGTCTTGGCTAA -> TTGGTATGTCTTGGCTAAC
TTTTAGCCAATGAGGCGAG -> TTTAGCCAATGAGGCGAGT
TTTTAGGTGCACGTAAAAT -> TTTAGGTGCACGTAAAATC
TTTTCGTAGGAGCAACATG -> TTTCGTAGGAGCAACATGA
TTTTCGTTATAGACTGTAA -> TTTCGTTATAGACTGTAAT
TTTTCTGCGGGCAGTTATA -> TTTCTGCGGGCAGTTATAG
TTTTGCTTCGGTAGCAAAC -> TTTGCTTCGGTAGCAAACG
TTTTTAGCCAATGAGGCGA -> TTTTAGCCAATGAGGCGAG

