AAAAAAAGAAC -> AAAAAAGAACT
AAAAAAGAACT -> AAAAAGAACTC
AAAAACGTATC -> AAAACGTATCC
AAAAACTGAGG -> AAAACTGAGGT
AAAAAGAACTC -> AAAAGAACTCT
AAAAATCCTTA -> AAAATCCTTAG
AAAACGTATCC -> AAACGTATCCT
AAAACTGAGGT -> AAACTGAGGTA
AAAAGAACTCT -> AAAGAACTCTA
AAAAGGATGGC -> AAAGGATGGCG
AAAATCCTTAG -> AAATCCTTAGG
AAAATTCTGTT -> AAATTCTGTTT
AAACCTCTTCG -> AACCTCTTCGC
AAACGAGAGAG -> AACGAGAGAGG
AAACGCCGGCT -> AACGCCGGCTC
AAACGGCGTCA -> AACGGCGTCAT
AAACGTATCCT -> AACGTATCCTG
AAACGTTAGGC -> AACGTTAGGCG
AAACTATTGCC -> AACTATTGCCC
AAACTGAGGTA -> AACTGAGGTAA
AAAGAACTCTA -> AAGAACTCTAC
AAAGATTTAAT -> AAGATTTAATC
AAAGCCTGCCT -> AAGCCTGCCTC
AAAGCGGGGGG -> AAGCGGGGGGC
AAAGGATCCAA -> AAGGATCCAAA
AAAGGATGGCG -> AAGGATGGCGT
AAAGGCGAGAC -> AAGGCGAGACA
AAAGGGGTGGG -> AAGGGGTGGGA
AAAGGTGGTCA -> AAGGTGGTCAG
AAAGTAGGTTA -> AAGTAGGTTAT
AAAGTTGTTTT -> AAGTTGTTTTT
AAATAATGTAA -> AATAATGTAAT
AAATCATATCA -> AATCATATCAC
AAATCCTTAGG -> AATCCTTAGGA
AAATTCCGCTA -> AATTCCGCTAG
AAATTCTGTTT -> AATTCTGTTTC
AACAAGCACTC -> ACAAGCACTCA
AACAGGTTACC -> ACAGGTTACCT
AACATCGAGTA -> ACATCGAGTAC
AACCAAGGCGC -> ACCAAGGCGCG
AACCACCCGCT -> ACCACCCGCTA
AACCATTTGGT -> ACCATTTGGTG
AACCCAGCGTG -> ACCCAGCGTGT
AACCCAGTCTT -> ACCCAGTCTTT
AACCCGGCATG -> ACCCGGCATGT
AACCCGTTTGA -> ACCCGTTTGAA
AACCGCTAGCT -> ACCGCTAGCTA
AACCGGGCGAA -> ACCGGGCGAAT
AACCTCTTCGC -> ACCTCTTCGCT
AACCTGGCGCA -> ACCTGGCGCAC
AACGAGAGAGG -> ACGAGAGAGGC
AACGCACTGTA -> ACGCACTGTAT
AACGCCGGCTC -> ACGCCGGCTCA
AACGGCGTCAT -> ACGGCGTCATC
AACGGTTCATG -> ACGGTTCATGC
AACGTATCCTG -> ACGTATCCTGC
AACGTTAGGCG -> ACGTTAGGCGA
AACTATTGCCC -> ACTATTGCCCG
AACTCCAGTAT -> ACTCCAGTATA
AACTCTACCTA -> ACTCTACCTAA
AACTCTCTAGT -> ACTCTCTAGTG
AACTGACATAG -> ACTGACATAGG
AACTGAGGTAA -> ACTGAGGTAAC
AAGAACTCTAC -> AGAACTCTACC
AAGAATTACTT -> AGAATTACTTA
AAGACACGATT -> AGACACGATTG
AAGACTTCGTA -> AGACTTCGTAC
AAGAGAATAAT -> AGAGAATAATA
AAGAGCGTATA -> AGAGCGTATAG
AAGAGGTCGCA -> AGAGGTCGCAA
AAGATCCGGAA -> AGATCCGGAAC
AAGATGCCACA -> AGATGCCACAA
AAGATGGTGCA -> AGATGGTGCAG
AAGATTTAATC -> AGATTTAATCA
AAGCACTCAGG -> AGCACTCAGGT
AAGCATACGAT -> AGCATACGATC
AAGCATCACAT -> AGCATCACATG
AAGCCCACCGA -> AGCCCACCGAA
AAGCCTGCCTC -> AGCCTGCCTCG
AAGCCTGCTGT -> AGCCTGCTGTT
AAGCGGGGGGC -> AGCGGGGGGCT
AAGCGTTCAGG -> AGCGTTCAGGT
AAGGAAAGGAT -> AGGAAAGGATC
AAGGAAATCAT -> AGGAAATCATA
AAGGAGCTAAT -> AGGAGCTAATT
AAGGATCCAAA -> AGGATCCAAAG
AAGGATGGCGT -> AGGATGGCGTA
AAGGCCGTTCC -> AGGCCGTTCCG
AAGGCGAGACA -> AGGCGAGACAC
AAGGCGCGCAC -> AGGCGCGCACT
AAGGCTGTCCG -> AGGCTGTCCGT
AAGGGCAGAGC -> AGGGCAGAGCG
AAGGGGTGGGA -> AGGGGTGGGAT
AAGGTGGTCAG -> AGGTGGTCAGG
AAGGTTCACCG -> AGGTTCACCGC
AAGTAGGTTAT -> AGTAGGTTATG
AAGTTACTGTC -> AGTTACTGTCC
AAGTTGAGACG -> AGTTGAGACGT
AAGTTGTCTCT -> AGTTGTCTCTG
AAGTTGTTTTT -> AGTTGTTTTTG
AATAAACGCCG -> ATAAACGCCGG
AATAAAGATTT -> ATAAAGATTTA
AATAAGATCCG -> ATAAGATCCGG
AATAAGGGCAG -> ATAAGGGCAGA
AATAAGGTTCA -> ATAAGGTTCAC
AATAATAGGCT -> ATAATAGGCTT
AATAATGTAAT -> ATAATGTAATA
AATACACTGCT -> ATACACTGCTA
AATACCGAGTC -> ATACCGAGTCT
AATAGGCTTGA -> ATAGGCTTGAT
AATATCTACGA -> ATATCTACGAC
AATCAATCGTC -> ATCAATCGTCA
AATCATATCAC -> ATCATATCACA
AATCCATGGAT -> ATCCATGGATA
AATCCTTAGGA -> ATCCTTAGGAG
AATCGTCAACC -> ATCGTCAACCC
AATCGTTGCAA -> ATCGTTGCAAG
AATCTCCTTGG -> ATCTCCTTGGC
AATCTGGAAAC -> ATCTGGAAACC
AATGAGAGGCA -> ATGAGAGGCAC
AATGAGCGCCA -> ATGAGCGCCAG
AATGCCCGACG -> ATGCCCGACGG
AATGGCAGCAA -> ATGGCAGCAAA
AATGTAATACC -> ATGTAATACCG
AATGTTTAATA -> ATGTTTAATAA
AATTAAAAACG -> ATTAAAAACGT
AATTACTTAAA -> ATTACTTAAAC
AATTCCGCTAG -> ATTCCGCTAGA
AATTCTGTTTC -> ATTCTGTTTCG
ACAAAAAAAGA -> CAAAAAAAGAA
ACAAAGGCGAG -> CAAAGGCGAGA
ACAAAGGTGGT -> CAAAGGTGGTC
ACAACAAGCAC -> CAACAAGCACT
ACAAGCACTCA -> CAAGCACTCAG
ACAAGTTACTG -> CAAGTTACTGT
ACAATAAACGC -> CAATAAACGCC
ACAATAAGGGC -> CAATAAGGGCA
ACAATACACTG -> CAATACACTGC
ACAATTAAAAA -> CAATTAAAAAC
ACACCAGGCTT -> CACCAGGCTTA
ACACGATTGCA -> CACGATTGCAA
ACACTGCTATC -> CACTGCTATCC
ACACTTTAGCA -> CACTTTAGCAA
ACAGAAGAATT -> CAGAAGAATTA
ACAGACAATAA -> CAGACAATAAA
ACAGAGAAATT -> CAGAGAAATTC
ACAGAGTATGG -> CAGAGTATGGC
ACAGGAATGAG -> CAGGAATGAGC
ACAGGACAATT -> CAGGACAATTA
ACAGGTTACCT -> CAGGTTACCTT
ACAGTCACCGT -> CAGTCACCGTC
ACATAGGGCAC -> CATAGGGCACG
ACATAGGTTCT -> CATAGGTTCTT
ACATCGAGTAC -> CATCGAGTACT
ACATGACGTTG -> CATGACGTTGA
ACATGACTCTG -> CATGACTCTGA
ACATGTAGGAC -> CATGTAGGACA
ACATTCTTTCC -> CATTCTTTCCT
ACCAACCCAGC -> CCAACCCAGCG
ACCAACCTGGC -> CCAACCTGGCG
ACCAACGGTTC -> CCAACGGTTCA
ACCAAGGCGCG -> CCAAGGCGCGC
ACCACCCGCTA -> CCACCCGCTAT
ACCAGGCTTAG -> CCAGGCTTAGC
ACCATCCTACG -> CCATCCTACGC
ACCATTTGGTG -> CCATTTGGTGA
ACCCAGCGTGT -> CCCAGCGTGTA
ACCCAGTCTTT -> CCCAGTCTTTC
ACCCGAATGTT -> CCCGAATGTTT
ACCCGCTATCT -> CCCGCTATCTA
ACCCGGCATGT -> CCCGGCATGTA
ACCCGGCCTTT -> CCCGGCCTTTT
ACCCGTTTGAA -> CCCGTTTGAAA
ACCCTCCCTGG -> CCCTCCCTGGA
ACCGAAGATGG -> CCGAAGATGGT
ACCGAAGGCCG -> CCGAAGGCCGT
ACCGACAGAAG -> CCGACAGAAGA
ACCGAGTCTGC -> CCGAGTCTGCT
ACCGCACGATG -> CCGCACGATGG
ACCGCGTGTTG -> CCGCGTGTTGG
ACCGCTAGCTA -> CCGCTAGCTAT
ACCGGGCGAAT -> CCGGGCGAATG
ACCGTCATGGT -> CCGTCATGGTT
ACCTAAGCCTG -> CCTAAGCCTGC
ACCTCTTCGCT -> CCTCTTCGCTT
ACCTGGCGCAC -> CCTGGCGCACG
ACCTTCATTTC -> CCTTCATTTCT
ACCTTCCGTTC -> CCTTCCGTTCC
ACGAACTCTCT -> CGAACTCTCTA
ACGACTAGTCT -> CGACTAGTCTT
ACGACTGGTAA -> CGACTGGTAAT
ACGAGAGAGGC -> CGAGAGAGGCA
ACGAGCTAAAA -> CGAGCTAAAAA
ACGATCGGGAG -> CGATCGGGAGA
ACGATCTGCTA -> CGATCTGCTAT
ACGATGGGACC -> CGATGGGACCG
ACGATTGCAAC -> CGATTGCAACA
ACGCACTGTAT -> CGCACTGTATG
ACGCCACAAAG -> CGCCACAAAGG
ACGCCACGATC -> CGCCACGATCG
ACGCCAGGATC -> CGCCAGGATCA
ACGCCCTGCAT -> CGCCCTGCATT
ACGCCGGCTCA -> CGCCGGCTCAG
ACGCCTCTCAC -> CGCCTCTCACG
ACGCGGCCGTT -> CGCGGCCGTTC
ACGCGTGTAAT -> CGCGTGTAATC
ACGGCGCGATT -> CGGCGCGATTT
ACGGCGTCATC -> CGGCGTCATCA
ACGGGTTCTAA -> CGGGTTCTAAT
ACGGTCCAAGC -> CGGTCCAAGCG
ACGGTTCATGC -> CGGTTCATGCA
ACGTACATTCT -> CGTACATTCTT
ACGTACGCCTC -> CGTACGCCTCT
ACGTATCCTGC -> CGTATCCTGCT
ACGTGAGCACC -> CGTGAGCACCG
ACGTGTGCATC -> CGTGTGCATCA
ACGTTAGGCGA -> CGTTAGGCGAG
ACGTTAGGTAT -> CGTTAGGTATC
ACGTTGAGCGT -> CGTTGAGCGTC
ACTACAACAAG -> CTACAACAAGC
ACTACCATCCT -> CTACCATCCTA
ACTAGTCTTGG -> CTAGTCTTGGG
ACTATGCTTTC -> CTATGCTTTCT
ACTATTGCCCG -> CTATTGCCCGC
ACTATTTTGAT -> CTATTTTGATG
ACTCACCAACG -> CTCACCAACGG
ACTCAGGTAAG -> CTCAGGTAAGT
ACTCCAGTATA -> CTCCAGTATAT
ACTCCCGGGTA -> CTCCCGGGTAA
ACTCTACCTAA -> CTCTACCTAAG
ACTCTCTAGTG -> CTCTCTAGTGT
ACTCTGAAGTT -> CTCTGAAGTTG
ACTCTGCCTAA -> CTCTGCCTAAA
ACTGACATAGG -> CTGACATAGGG
ACTGAGGTAAC -> CTGAGGTAACC
ACTGCACAAAA -> CTGCACAAAAA
ACTGCTATCCA -> CTGCTATCCAG
ACTGGTAATAA -> CTGGTAATAAG
ACTGTATGATC -> CTGTATGATCC
ACTGTCCGGGT -> CTGTCCGGGTG
ACTTAAACGGC -> CTTAAACGGCG
ACTTAAACGTT -> CTTAAACGTTA
ACTTCGTACGA -> CTTCGTACGAA
ACTTCTGAACA -> CTTCTGAACAT
ACTTTAGCAAA -> CTTTAGCAAAA
AGAAATTCCGC -> GAAATTCCGCT
AGAACCCAGTC -> GAACCCAGTCT
AGAACTCTACC -> GAACTCTACCT
AGAAGAATTAC -> GAAGAATTACT
AGAAGGAAAGG -> GAAGGAAAGGA
AGAATAATAGG -> GAATAATAGGC
AGAATATCTAC -> GAATATCTACG
AGAATGCCCGA -> GAATGCCCGAC
AGAATTACTTA -> GAATTACTTAA
AGACAATAAAC -> GACAATAAACG
AGACACCAGGC -> GACACCAGGCT
AGACACGATTG -> GACACGATTGC
AGACCCGAATG -> GACCCGAATGT
AGACCTTCATT -> GACCTTCATTT
AGACGTTAGGT -> GACGTTAGGTA
AGACTTCGTAC -> GACTTCGTACG
AGAGAAATTCC -> GAGAAATTCCG
AGAGAATAATA -> GAGAATAATAG
AGAGACCCGAA -> GAGACCCGAAT
AGAGAGGCACA -> GAGAGGCACAA
AGAGCGAAGGA -> GAGCGAAGGAG
AGAGCGTATAG -> GAGCGTATAGC
AGAGCTAGAGT -> GAGCTAGAGTC
AGAGGCACAAG -> GAGGCACAAGT
AGAGGCACTAT -> GAGGCACTATG
AGAGGTCGCAA -> GAGGTCGCAAG
AGAGTATGGCG -> GAGTATGGCGC
AGAGTCATACA -> GAGTCATACAT
AGAGTCTGCTA -> GAGTCTGCTAA
AGAGTGAGAGC -> GAGTGAGAGCT
AGATCCGGAAC -> GATCCGGAACC
AGATCGCTATA -> GATCGCTATAT
AGATCTATTTA -> GATCTATTTAG
AGATGCCACAA -> GATGCCACAAA
AGATGGTGCAG -> GATGGTGCAGC
AGATGTGCCCG -> GATGTGCCCGT
AGATTACGTAC -> GATTACGTACA
AGATTTAATCA -> GATTTAATCAA
AGATTTGAACT -> GATTTGAACTC
AGATTTTGCCT -> GATTTTGCCTT
AGCAAAAACTG -> GCAAAAACTGA
AGCAAAATTCT -> GCAAAATTCTG
AGCACCGCGTG -> GCACCGCGTGT
AGCACTCAGGT -> GCACTCAGGTA
AGCAGATGTGC -> GCAGATGTGCC
AGCATACGATC -> GCATACGATCT
AGCATAGCGCG -> GCATAGCGCGT
AGCATCACATG -> GCATCACATGA
AGCATTGCGTT -> GCATTGCGTTA
AGCCCACCGAA -> GCCCACCGAAG
AGCCCCGAAAG -> GCCCCGAAAGC
AGCCCGAGATT -> GCCCGAGATTA
AGCCTGCCTCG -> GCCTGCCTCGA
AGCCTGCTGTT -> GCCTGCTGTTG
AGCCTTCTTAA -> GCCTTCTTAAA
AGCGAAGGAGC -> GCGAAGGAGCT
AGCGACGGCGC -> GCGACGGCGCG
AGCGCCAGAGA -> GCGCCAGAGAC
AGCGCGTCTTT -> GCGCGTCTTTC
AGCGCTCAGCC -> GCGCTCAGCCC
AGCGGCCCCTT -> GCGGCCCCTTC
AGCGGGGGGCT -> GCGGGGGGCTT
AGCGTACAGAG -> GCGTACAGAGT
AGCGTAGCATA -> GCGTAGCATAG
AGCGTATAGCA -> GCGTATAGCAT
AGCGTCATTCA -> GCGTCATTCAT
AGCGTGTAGCG -> GCGTGTAGCGG
AGCGTTCAGGT -> GCGTTCAGGTC
AGCTAAAAATC -> GCTAAAAATCC
AGCTAATTATT -> GCTAATTATTA
AGCTAGAGTCT -> GCTAGAGTCTG
AGCTATAAGAC -> GCTATAAGACT
AGCTCATGTAC -> GCTCATGTACG
AGCTTGGAGGC -> GCTTGGAGGCA
AGGAAAGGATC -> GGAAAGGATCC
AGGAAATCATA -> GGAAATCATAT
AGGAATGAGCG -> GGAATGAGCGC
AGGACAATTAA -> GGACAATTAAA
AGGACAGGACA -> GGACAGGACAA
AGGAGCTAATT -> GGAGCTAATTA
AGGAGGCCTTA -> GGAGGCCTTAT
AGGATCATTTA -> GGATCATTTAG
AGGATCCAAAG -> GGATCCAAAGG
AGGATCGTCGG -> GGATCGTCGGT
AGGATGGCGTA -> GGATGGCGTAC
AGGCACAAGTT -> GGCACAAGTTA
AGGCACTATGC -> GGCACTATGCT
AGGCATGCGTT -> GGCATGCGTTC
AGGCCGTTCCG -> GGCCGTTCCGG
AGGCCTTATCA -> GGCCTTATCAG
AGGCGAGACAC -> GGCGAGACACC
AGGCGAGTAGT -> GGCGAGTAGTA
AGGCGCGCACT -> GGCGCGCACTG
AGGCTGTCCGT -> GGCTGTCCGTA
AGGCTTAGCCC -> GGCTTAGCCCG
AGGCTTGATGG -> GGCTTGATGGC
AGGGACTCCCG -> GGGACTCCCGG
AGGGATTCCAG -> GGGATTCCAGA
AGGGCACGCCC -> GGGCACGCCCT
AGGGCAGAGCG -> GGGCAGAGCGA
AGGGGTGGGAT -> GGGGTGGGATG
AGGTAACCGCT -> GGTAACCGCTA
AGGTAAGTTGA -> GGTAAGTTGAG
AGGTATCAGCG -> GGTATCAGCGC
AGGTCGCAAGC -> GGTCGCAAGCA
AGGTCTATACA -> GGTCTATACAG
AGGTGGTCAGG -> GGTGGTCAGGT
AGGTTACCTTC -> GGTTACCTTCC
AGGTTATGGTG -> GGTTATGGTGG
AGGTTCACCGC -> GGTTCACCGCA
AGGTTCTTTAT -> GGTTCTTTATA
AGGTTTGAGAA -> GGTTTGAGAAT
AGTAAGAGAAT -> GTAAGAGAATA
AGTAAGCCCAC -> GTAAGCCCACC
AGTACTTAAAC -> GTACTTAAACG
AGTAGGTTATG -> GTAGGTTATGG
AGTAGTAAGCC -> GTAGTAAGCCC
AGTATATTAAC -> GTATATTAACT
AGTATGATAAG -> GTATGATAAGA
AGTATGGCGCA -> GTATGGCGCAT
AGTCACCGTCA -> GTCACCGTCAT
AGTCATACATG -> GTCATACATGT
AGTCTCGATTA -> GTCTCGATTAA
AGTCTGCTAAT -> GTCTGCTAATG
AGTCTGCTTAA -> GTCTGCTTAAC
AGTCTTGGGAT -> GTCTTGGGATT
AGTCTTTCGAA -> GTCTTTCGAAG
AGTGAGAGCTA -> GTGAGAGCTAG
AGTGCCACATA -> GTGCCACATAG
AGTGTGTAGAG -> GTGTGTAGAGT
AGTTACTGTCC -> GTTACTGTCCG
AGTTCCAGCGA -> GTTCCAGCGAC
AGTTCTAATCT -> GTTCTAATCTG
AGTTGAGACGT -> GTTGAGACGTT
AGTTGTCTCTG -> GTTGTCTCTGT
AGTTGTGGCTC -> GTTGTGGCTCG
AGTTGTTTTTG -> GTTGTTTTTGT
ATAAACGCCGG -> TAAACGCCGGC
ATAAACTATTG -> TAAACTATTGC
ATAAAGATTTA -> TAAAGATTTAA
ATAACCACCCG -> TAACCACCCGC
ATAACCATTTG -> TAACCATTTGG
ATAACCGGGCG -> TAACCGGGCGA
ATAAGACTTCG -> TAAGACTTCGT
ATAAGAGCGTA -> TAAGAGCGTAT
ATAAGATCCGG -> TAAGATCCGGA
ATAAGGGCAGA -> TAAGGGCAGAG
ATAAGGTTCAC -> TAAGGTTCACC
ATAATAGGCTT -> TAATAGGCTTG
ATAATGTAATA -> TAATGTAATAC
ATACACTGCTA -> TACACTGCTAT
ATACAGGAATG -> TACAGGAATGA
ATACATGTAGG -> TACATGTAGGA
ATACCCGGCCT -> TACCCGGCCTT
ATACCGAGTCT -> TACCGAGTCTG
ATACGATCTGC -> TACGATCTGCT
ATAGCATTGCG -> TAGCATTGCGT
ATAGCGCGTCT -> TAGCGCGTCTT
ATAGCGTACAG -> TAGCGTACAGA
ATAGCTTGGAG -> TAGCTTGGAGG
ATAGGCTTGAT -> TAGGCTTGATG
ATAGGGCACGC -> TAGGGCACGCC
ATAGGTTCTTT -> TAGGTTCTTTA
ATATCACAATA -> TATCACAATAC
ATATCTACGAC -> TATCTACGACT
ATATTAACTGA -> TATTAACTGAC
ATATTCTACCG -> TATTCTACCGA
ATATTTGCAGT -> TATTTGCAGTA
ATCAATCGTCA -> TCAATCGTCAA
ATCACAATACA -> TCACAATACAC
ATCACATGACG -> TCACATGACGT
ATCACTACCAT -> TCACTACCATC
ATCAGCAGATG -> TCAGCAGATGT
ATCAGCGCTCA -> TCAGCGCTCAG
ATCAGTCTCGA -> TCAGTCTCGAT
ATCAGTGCCAC -> TCAGTGCCACA
ATCATATCACA -> TCATATCACAA
ATCATTTAGTT -> TCATTTAGTTC
ATCCAAAGGGG -> TCCAAAGGGGT
ATCCAGCCTTC -> TCCAGCCTTCT
ATCCAGTATGA -> TCCAGTATGAT
ATCCAGTTGTG -> TCCAGTTGTGG
ATCCATGGATA -> TCCATGGATAC
ATCCCCACTAT -> TCCCCACTATT
ATCCGGAACCA -> TCCGGAACCAA
ATCCTACGCCA -> TCCTACGCCAC
ATCCTGCTTGA -> TCCTGCTTGAC
ATCCTTAGGAG -> TCCTTAGGAGG
ATCGAGTACTT -> TCGAGTACTTA
ATCGCTATATT -> TCGCTATATTC
ATCGGGAGACC -> TCGGGAGACCT
ATCGTCAACCC -> TCGTCAACCCG
ATCGTCGGTGA -> TCGTCGGTGAT
ATCGTGGGTTG -> TCGTGGGTTGC
ATCGTTGCAAG -> TCGTTGCAAGC
ATCTACAGTCA -> TCTACAGTCAC
ATCTACGACTG -> TCTACGACTGG
ATCTAGGGATT -> TCTAGGGATTC
ATCTATTTAGA -> TCTATTTAGAA
ATCTCCTTGGC -> TCTCCTTGGCT
ATCTGCTATCT -> TCTGCTATCTG
ATCTGGAAACC -> TCTGGAAACCT
ATCTGTGTAGA -> TCTGTGTAGAT
ATGACAATAAG -> TGACAATAAGG
ATGACGGTCCA -> TGACGGTCCAA
ATGACGTTGAG -> TGACGTTGAGC
ATGACTCTGAA -> TGACTCTGAAG
ATGAGAGGCAC -> TGAGAGGCACT
ATGAGCGCCAG -> TGAGCGCCAGA
ATGATAAGAGC -> TGATAAGAGCG
ATGATCCCCAC -> TGATCCCCACT
ATGCAGATCGC -> TGCAGATCGCT
ATGCCACAAAG -> TGCCACAAAGG
ATGCCCGACGG -> TGCCCGACGGG
ATGCGTTCCGC -> TGCGTTCCGCG
ATGCTTTCTAG -> TGCTTTCTAGA
ATGGATACCCG -> TGGATACCCGG
ATGGCAGCAAA -> TGGCAGCAAAA
ATGGCGATTTG -> TGGCGATTTGT
ATGGCGCATCA -> TGGCGCATCAC
ATGGCGTACAG -> TGGCGTACAGA
ATGGGACCGAC -> TGGGACCGACA
ATGGTGCAGCG -> TGGTGCAGCGT
ATGGTGCGGGA -> TGGTGCGGGAC
ATGGTGGCACT -> TGGTGGCACTT
ATGGTTCTGTA -> TGGTTCTGTAC
ATGTAAAAGGA -> TGTAAAAGGAT
ATGTAATACCG -> TGTAATACCGA
ATGTACGCGTG -> TGTACGCGTGT
ATGTAGGACAG -> TGTAGGACAGG
ATGTAGGGACT -> TGTAGGGACTC
ATGTATCCAGT -> TGTATCCAGTT
ATGTGCCCGTC -> TGTGCCCGTCG
ATGTGCGCACA -> TGTGCGCACAT
ATGTTTAATAA -> TGTTTAATAAA
ATTAAAAACGT -> TTAAAAACGTA
ATTAACTGACA -> TTAACTGACAT
ATTAAGGAAAT -> TTAAGGAAATC
ATTAATAAGAT -> TTAATAAGATC
ATTACGTACAT -> TTACGTACATT
ATTACTTAAAC -> TTACTTAAACG
ATTCACGAGCT -> TTCACGAGCTA
ATTCATTCACG -> TTCATTCACGA
ATTCCAGAAGG -> TTCCAGAAGGA
ATTCCGCTAGA -> TTCCGCTAGAT
ATTCCTAGTTC -> TTCCTAGTTCC
ATTCTACCGAA -> TTCTACCGAAG
ATTCTGTTTCG -> TTCTGTTTCGC
ATTCTTTCCTT -> TTCTTTCCTTA
ATTGCAACAGG -> TTGCAACAGGT
ATTGCCCGCGG -> TTGCCCGCGGC
ATTGCGTTACG -> TTGCGTTACGT
ATTTAATCAAT -> TTTAATCAATC
ATTTAGAATAT -> TTTAGAATATC
ATTTAGTTCTA -> TTTAGTTCTAA
ATTTCTAAACG -> TTTCTAAACGA
ATTTGAACTCC -> TTTGAACTCCA
ATTTGCAACGC -> TTTGCAACGCA
ATTTGCAGTAA -> TTTGCAGTAAG
ATTTGGTGAAG -> TTTGGTGAAGG
ATTTGTTAGAT -> TTTGTTAGATT
ATTTTGATGTA -> TTTTGATGTAA
ATTTTGCCTTG -> TTTTGCCTTGG
ATTTTGCTATA -> TTTTGCTATAT
CAAAAAAAGAA -> AAAAAAAGAAC
CAAAAACTGAG -> AAAAACTGAGG
CAAAATTCTGT -> AAAATTCTGTT
CAAAGCCTGCC -> AAAGCCTGCCT
CAAAGGCGAGA -> AAAGGCGAGAC
CAAAGGGGTGG -> AAAGGGGTGGG
CAAAGGTGGTC -> AAAGGTGGTCA
CAACAAGCACT -> AACAAGCACTC
CAACAGGTTAC -> AACAGGTTACC
CAACCCAGCGT -> AACCCAGCGTG
CAACCCGTTTG -> AACCCGTTTGA
CAACCTGGCGC -> AACCTGGCGCA
CAACGCACTGT -> AACGCACTGTA
CAACGGTTCAT -> AACGGTTCATG
CAAGCACTCAG -> AAGCACTCAGG
CAAGCATACGA -> AAGCATACGAT
CAAGCATCACA -> AAGCATCACAT
CAAGCGTTCAG -> AAGCGTTCAGG
CAAGGCGCGCA -> AAGGCGCGCAC
CAAGTTACTGT -> AAGTTACTGTC
CAATAAACGCC -> AATAAACGCCG
CAATAAGGGCA -> AATAAGGGCAG
CAATACACTGC -> AATACACTGCT
CAATCGTCAAC -> AATCGTCAACC
CAATTAAAAAC -> AATTAAAAACG
CACAAAAAAAG -> ACAAAAAAAGA
CACAAAGGCGA -> ACAAAGGCGAG
CACAAAGGTGG -> ACAAAGGTGGT
CACAAGTTACT -> ACAAGTTACTG
CACAATACACT -> ACAATACACTG
CACATAGGTTC -> ACATAGGTTCT
CACATGACGTT -> ACATGACGTTG
CACATGACTCT -> ACATGACTCTG
CACCAACGGTT -> ACCAACGGTTC
CACCAGGCTTA -> ACCAGGCTTAG
CACCCGCTATC -> ACCCGCTATCT
CACCGAAGGCC -> ACCGAAGGCCG
CACCGCACGAT -> ACCGCACGATG
CACCGCGTGTT -> ACCGCGTGTTG
CACCGTCATGG -> ACCGTCATGGT
CACGAGCTAAA -> ACGAGCTAAAA
CACGATCGGGA -> ACGATCGGGAG
CACGATGGGAC -> ACGATGGGACC
CACGATTGCAA -> ACGATTGCAAC
CACGCCACGAT -> ACGCCACGATC
CACGCCAGGAT -> ACGCCAGGATC
CACGCCCTGCA -> ACGCCCTGCAT
CACGTACGCCT -> ACGTACGCCTC
CACTACCATCC -> ACTACCATCCT
CACTATGCTTT -> ACTATGCTTTC
CACTATTTTGA -> ACTATTTTGAT
CACTCAGGTAA -> ACTCAGGTAAG
CACTGCACAAA -> ACTGCACAAAA
CACTGCTATCC -> ACTGCTATCCA
CACTGTATGAT -> ACTGTATGATC
CACTTCTGAAC -> ACTTCTGAACA
CACTTTAGCAA -> ACTTTAGCAAA
CAGAAGAATTA -> AGAAGAATTAC
CAGAAGGAAAG -> AGAAGGAAAGG
CAGACAATAAA -> AGACAATAAAC
CAGAGAAATTC -> AGAGAAATTCC
CAGAGACCCGA -> AGAGACCCGAA
CAGAGCGAAGG -> AGAGCGAAGGA
CAGAGTATGGC -> AGAGTATGGCG
CAGATCGCTAT -> AGATCGCTATA
CAGATGTGCCC -> AGATGTGCCCG
CAGCAAAATTC -> AGCAAAATTCT
CAGCAGATGTG -> AGCAGATGTGC
CAGCCCCGAAA -> AGCCCCGAAAG
CAGCCTTCTTA -> AGCCTTCTTAA
CAGCGACGGCG -> AGCGACGGCGC
CAGCGCTCAGC -> AGCGCTCAGCC
CAGCGTAGCAT -> AGCGTAGCATA
CAGCGTGTAGC -> AGCGTGTAGCG
CAGCTCATGTA -> AGCTCATGTAC
CAGGAATGAGC -> AGGAATGAGCG
CAGGACAATTA -> AGGACAATTAA
CAGGATCATTT -> AGGATCATTTA
CAGGCTTAGCC -> AGGCTTAGCCC
CAGGTAAGTTG -> AGGTAAGTTGA
CAGGTCTATAC -> AGGTCTATACA
CAGGTTACCTT -> AGGTTACCTTC
CAGGTTTGAGA -> AGGTTTGAGAA
CAGTAAGAGAA -> AGTAAGAGAAT
CAGTATATTAA -> AGTATATTAAC
CAGTATGATAA -> AGTATGATAAG
CAGTCACCGTC -> AGTCACCGTCA
CAGTCTCGATT -> AGTCTCGATTA
CAGTCTTTCGA -> AGTCTTTCGAA
CAGTGCCACAT -> AGTGCCACATA
CAGTTGTGGCT -> AGTTGTGGCTC
CATAAACTATT -> ATAAACTATTG
CATACATGTAG -> ATACATGTAGG
CATACGATCTG -> ATACGATCTGC
CATAGCGCGTC -> ATAGCGCGTCT
CATAGGGCACG -> ATAGGGCACGC
CATAGGTTCTT -> ATAGGTTCTTT
CATATCACAAT -> ATATCACAATA
CATCACATGAC -> ATCACATGACG
CATCACTACCA -> ATCACTACCAT
CATCAGCAGAT -> ATCAGCAGATG
CATCAGTCTCG -> ATCAGTCTCGA
CATCCTACGCC -> ATCCTACGCCA
CATCGAGTACT -> ATCGAGTACTT
CATCGTGGGTT -> ATCGTGGGTTG
CATGACGGTCC -> ATGACGGTCCA
CATGACGTTGA -> ATGACGTTGAG
CATGACTCTGA -> ATGACTCTGAA
CATGCAGATCG -> ATGCAGATCGC
CATGCGTTCCG -> ATGCGTTCCGC
CATGGATACCC -> ATGGATACCCG
CATGGTTCTGT -> ATGGTTCTGTA
CATGTACGCGT -> ATGTACGCGTG
CATGTAGGACA -> ATGTAGGACAG
CATGTATCCAG -> ATGTATCCAGT
CATTCACGAGC -> ATTCACGAGCT
CATTCATTCAC -> ATTCATTCACG
CATTCTTTCCT -> ATTCTTTCCTT
CATTGCGTTAC -> ATTGCGTTACG
CATTTAGTTCT -> ATTTAGTTCTA
CATTTCTAAAC -> ATTTCTAAACG
CATTTGCAACG -> ATTTGCAACGC
CATTTGGTGAA -> ATTTGGTGAAG
CCAAAGGGGTG -> CAAAGGGGTGG
CCAACCCAGCG -> CAACCCAGCGT
CCAACCTGGCG -> CAACCTGGCGC
CCAACGGTTCA -> CAACGGTTCAT
CCAAGCGTTCA -> CAAGCGTTCAG
CCAAGGCGCGC -> CAAGGCGCGCA
CCACAAAGGCG -> CACAAAGGCGA
CCACAAAGGTG -> CACAAAGGTGG
CCACATAGGTT -> CACATAGGTTC
CCACCCGCTAT -> CACCCGCTATC
CCACCGAAGGC -> CACCGAAGGCC
CCACGATCGGG -> CACGATCGGGA
CCACTATTTTG -> CACTATTTTGA
CCAGAAGGAAA -> CAGAAGGAAAG
CCAGAGACCCG -> CAGAGACCCGA
CCAGCCTTCTT -> CAGCCTTCTTA
CCAGCGACGGC -> CAGCGACGGCG
CCAGCGTGTAG -> CAGCGTGTAGC
CCAGGATCATT -> CAGGATCATTT
CCAGGCTTAGC -> CAGGCTTAGCC
CCAGTATATTA -> CAGTATATTAA
CCAGTATGATA -> CAGTATGATAA
CCAGTCTTTCG -> CAGTCTTTCGA
CCAGTTGTGGC -> CAGTTGTGGCT
CCATAAACTAT -> CATAAACTATT
CCATCCTACGC -> CATCCTACGCC
CCATGACGGTC -> CATGACGGTCC
CCATGGATACC -> CATGGATACCC
CCATTTGGTGA -> CATTTGGTGAA
CCCACCGAAGG -> CCACCGAAGGC
CCCACTATTTT -> CCACTATTTTG
CCCAGCGTGTA -> CCAGCGTGTAG
CCCAGTCTTTC -> CCAGTCTTTCG
CCCATAAACTA -> CCATAAACTAT
CCCCACTATTT -> CCCACTATTTT
CCCCATAAACT -> CCCATAAACTA
CCCCGAAAGCG -> CCCGAAAGCGG
CCCCTTCTAGA -> CCCTTCTAGAA
CCCGAAAGCGG -> CCGAAAGCGGG
CCCGAAGAGGT -> CCGAAGAGGTC
CCCGAATGTTT -> CCGAATGTTTA
CCCGACGGGTT -> CCGACGGGTTC
CCCGAGATTAC -> CCGAGATTACG
CCCGCGGCCGG -> CCGCGGCCGGT
CCCGCTATCTA -> CCGCTATCTAC
CCCGGCATGTA -> CCGGCATGTAT
CCCGGCCTTTT -> CCGGCCTTTTA
CCCGGGTAAGA -> CCGGGTAAGAT
CCCGTCGTACT -> CCGTCGTACTA
CCCGTTTGAAA -> CCGTTTGAAAG
CCCTCCCTGGA -> CCTCCCTGGAG
CCCTGCATTTG -> CCTGCATTTGC
CCCTGGAGGAT -> CCTGGAGGATC
CCCTTCTAGAA -> CCTTCTAGAAC
CCGAAAGCGGG -> CGAAAGCGGGG
CCGAAGAGGTC -> CGAAGAGGTCG
CCGAAGATGGT -> CGAAGATGGTG
CCGAAGGCCGT -> CGAAGGCCGTT
CCGAATGTTTA -> CGAATGTTTAA
CCGACAGAAGA -> CGACAGAAGAA
CCGACGGGTTC -> CGACGGGTTCT
CCGACTCTGCC -> CGACTCTGCCT
CCGAGATTACG -> CGAGATTACGT
CCGAGTCTGCT -> CGAGTCTGCTT
CCGATAACCAT -> CGATAACCATT
CCGCACGATGG -> CGCACGATGGG
CCGCGGCCGGT -> CGCGGCCGGTA
CCGCGGCCGTT -> CGCGGCCGTTC
CCGCGTGTTGG -> CGCGTGTTGGG
CCGCTAGATTT -> CGCTAGATTTT
CCGCTAGCTAT -> CGCTAGCTATA
CCGCTATCTAC -> CGCTATCTACA
CCGGAACCAAG -> CGGAACCAAGG
CCGGACGTGAG -> CGGACGTGAGC
CCGGCATGTAT -> CGGCATGTATC
CCGGCCTTTTA -> CGGCCTTTTAC
CCGGCTCAGCT -> CGGCTCAGCTC
CCGGGCGAATG -> CGGGCGAATGG
CCGGGGGCCAT -> CGGGGGCCATG
CCGGGTAAGAT -> CGGGTAAGATG
CCGGGTGTCGT -> CGGGTGTCGTA
CCGGTACGACT -> CGGTACGACTA
CCGTATAACCG -> CGTATAACCGG
CCGTCATGGTT -> CGTCATGGTTC
CCGTCGTACTA -> CGTCGTACTAC
CCGTTCACGCC -> CGTTCACGCCA
CCGTTCCGATA -> CGTTCCGATAA
CCGTTCCGGAC -> CGTTCCGGACG
CCGTTCGGCGG -> CGTTCGGCGGC
CCGTTTGAAAG -> CGTTTGAAAGT
CCTAAAGTAGG -> CTAAAGTAGGT
CCTAAGCCTGC -> CTAAGCCTGCT
CCTACGCCACA -> CTACGCCACAA
CCTAGTTCCAG -> CTAGTTCCAGC
CCTCCCCATAA -> CTCCCCATAAA
CCTCCCTGGAG -> CTCCCTGGAGG
CCTCGATCCAG -> CTCGATCCAGT
CCTCTCACGCC -> CTCTCACGCCA
CCTCTTCGCTT -> CTCTTCGCTTG
CCTGCATTTGC -> CTGCATTTGCA
CCTGCCTCGAT -> CTGCCTCGATC
CCTGCTGTTGT -> CTGCTGTTGTT
CCTGCTTGACC -> CTGCTTGACCA
CCTGGAGGATC -> CTGGAGGATCG
CCTGGCGCACG -> CTGGCGCACGT
CCTTAGGAGGC -> CTTAGGAGGCC
CCTTATAACCA -> CTTATAACCAC
CCTTATCAGTG -> CTTATCAGTGC
CCTTCATTTCT -> CTTCATTTCTA
CCTTCCGTTCC -> CTTCCGTTCCG
CCTTCTAGAAC -> CTTCTAGAACC
CCTTCTTAAAT -> CTTCTTAAATA
CCTTGGCTTAT -> CTTGGCTTATT
CCTTGGGGGTG -> CTTGGGGGTGT
CCTTTTACGCG -> CTTTTACGCGG
CGAAAGCGGGG -> GAAAGCGGGGG
CGAACTCTCTA -> GAACTCTCTAG
CGAAGACACGA -> GAAGACACGAT
CGAAGAGGTCG -> GAAGAGGTCGC
CGAAGATGGTG -> GAAGATGGTGC
CGAAGGAGCTA -> GAAGGAGCTAA
CGAAGGCCGTT -> GAAGGCCGTTC
CGAATGGCAGC -> GAATGGCAGCA
CGAATGTTTAA -> GAATGTTTAAT
CGACAGAAGAA -> GACAGAAGAAT
CGACGGCGCGA -> GACGGCGCGAT
CGACGGGTTCT -> GACGGGTTCTA
CGACTAGTCTT -> GACTAGTCTTG
CGACTCTGCCT -> GACTCTGCCTA
CGACTGGTAAT -> GACTGGTAATA
CGAGACACCAG -> GAGACACCAGG
CGAGAGAGGCA -> GAGAGAGGCAC
CGAGATTACGT -> GAGATTACGTA
CGAGCTAAAAA -> GAGCTAAAAAT
CGAGTACTTAA -> GAGTACTTAAA
CGAGTAGTAAG -> GAGTAGTAAGC
CGAGTCTGCTT -> GAGTCTGCTTA
CGATAACCATT -> GATAACCATTT
CGATCCAGTAT -> GATCCAGTATG
CGATCGGGAGA -> GATCGGGAGAC
CGATCTGCTAT -> GATCTGCTATC
CGATGGGACCG -> GATGGGACCGA
CGATTAAGGAA -> GATTAAGGAAA
CGATTGCAACA -> GATTGCAACAG
CGATTTGTTAG -> GATTTGTTAGA
CGATTTTGCTA -> GATTTTGCTAT
CGCAAGCATCA -> GCAAGCATCAC
CGCACATGACT -> GCACATGACTC
CGCACGATGGG -> GCACGATGGGA
CGCACGTACGC -> GCACGTACGCC
CGCACTGCACA -> GCACTGCACAA
CGCACTGTATG -> GCACTGTATGA
CGCATCACTAC -> GCATCACTACC
CGCCACAAAGG -> GCCACAAAGGT
CGCCACGATCG -> GCCACGATCGG
CGCCAGAGACC -> GCCAGAGACCC
CGCCAGGATCA -> GCCAGGATCAT
CGCCCTGCATT -> GCCCTGCATTT
CGCCGACTCTG -> GCCGACTCTGC
CGCCGGCTCAG -> GCCGGCTCAGC
CGCCTCTCACG -> GCCTCTCACGC
CGCGATTTTGC -> GCGATTTTGCT
CGCGCACTGCA -> GCGCACTGCAC
CGCGGCCGGTA -> GCGGCCGGTAC
CGCGGCCGTTC -> GCGGCCGTTCA,GCGGCCGTTCG
CGCGTCTTTCG -> GCGTCTTTCGC
CGCGTGTAATC -> GCGTGTAATCT
CGCGTGTTGGG -> GCGTGTTGGGG
CGCTAGATTTT -> GCTAGATTTTG
CGCTAGCTATA -> GCTAGCTATAA
CGCTATATTCT -> GCTATATTCTA
CGCTATCTACA -> GCTATCTACAG
CGCTCAGCCCC -> GCTCAGCCCCG
CGCTGCCCGAA -> GCTGCCCGAAG
CGCTTGCAAAG -> GCTTGCAAAGC
CGGAACCAAGG -> GGAACCAAGGC
CGGACGTGAGC -> GGACGTGAGCA
CGGCATGTATC -> GGCATGTATCC
CGGCCCCTTCT -> GGCCCCTTCTA
CGGCCGGTACG -> GGCCGGTACGA
CGGCCGTTCAC -> GGCCGTTCACG
CGGCCGTTCGG -> GGCCGTTCGGC
CGGCCTTTTAC -> GGCCTTTTACG
CGGCGCGATTT -> GGCGCGATTTT
CGGCGGCGGGG -> GGCGGCGGGGA
CGGCGGGGACA -> GGCGGGGACAC
CGGCGTCATCA -> GGCGTCATCAG
CGGCTCAGCTC -> GGCTCAGCTCA
CGGGACTCACC -> GGGACTCACCA
CGGGAGACCTT -> GGGAGACCTTC
CGGGCGAATGG -> GGGCGAATGGC
CGGGGACACTT -> GGGGACACTTT
CGGGGGCCATG -> GGGGGCCATGA
CGGGGGGCTTC -> GGGGGGCTTCC
CGGGTAAGATG -> GGGTAAGATGC
CGGGTGTCGTA -> GGGTGTCGTAT
CGGGTTCTAAT -> GGGTTCTAATC
CGGTACGACTA -> GGTACGACTAG
CGGTCCAAGCG -> GGTCCAAGCGT
CGGTGAATCGT -> GGTGAATCGTT
CGGTGATGACA -> GGTGATGACAA
CGGTTCATGCA -> GGTTCATGCAG
CGTACAGAGAA -> GTACAGAGAAA
CGTACAGAGTA -> GTACAGAGTAT
CGTACATTCTT -> GTACATTCTTT
CGTACGAACTC -> GTACGAACTCT
CGTACGCCTCT -> GTACGCCTCTC
CGTACTACAAC -> GTACTACAACA
CGTAGCATAGC -> GTAGCATAGCG
CGTATAACCGG -> GTATAACCGGG
CGTATAGCATT -> GTATAGCATTG
CGTATCCTGCT -> GTATCCTGCTT
CGTATGTGCGC -> GTATGTGCGCA
CGTCAACCCGT -> GTCAACCCGTT
CGTCATCAGTC -> GTCATCAGTCT
CGTCATGGTTC -> GTCATGGTTCT
CGTCATTCATT -> GTCATTCATTC
CGTCGGTGATG -> GTCGGTGATGA
CGTCGTACTAC -> GTCGTACTACA
CGTCTTTCGCT -> GTCTTTCGCTG
CGTGAGCACCG -> GTGAGCACCGC
CGTGGGTTGCG -> GTGGGTTGCGG
CGTGTAATCTC -> GTGTAATCTCC
CGTGTAGCGGC -> GTGTAGCGGCC
CGTGTGCATCA -> GTGTGCATCAG
CGTGTTGATGT -> GTGTTGATGTA
CGTGTTGGGGT -> GTGTTGGGGTA
CGTTACGTGTG -> GTTACGTGTGC
CGTTAGGCGAG -> GTTAGGCGAGT
CGTTAGGTATC -> GTTAGGTATCA
CGTTCACGCCA -> GTTCACGCCAG
CGTTCAGGTCT -> GTTCAGGTCTA
CGTTCCGATAA -> GTTCCGATAAC
CGTTCCGCGGC -> GTTCCGCGGCC
CGTTCCGGACG -> GTTCCGGACGT
CGTTCGGCGGC -> GTTCGGCGGCG
CGTTGAGCGTC -> GTTGAGCGTCA
CGTTGCAAGCA -> GTTGCAAGCAT
CGTTTGAAAGT -> GTTTGAAAGTT
CTAAAAATCCT -> TAAAAATCCTT
CTAAACGAGAG -> TAAACGAGAGA
CTAAAGTAGGT -> TAAAGTAGGTT
CTAAGCCTGCT -> TAAGCCTGCTG
CTAATCCATGG -> TAATCCATGGA
CTAATCTGGAA -> TAATCTGGAAA
CTAATGAGAGG -> TAATGAGAGGC
CTACAACAAGC -> TACAACAAGCA
CTACAGTCACC -> TACAGTCACCG
CTACCATCCTA -> TACCATCCTAC
CTACCGAAGAT -> TACCGAAGATG
CTACCTAAGCC -> TACCTAAGCCT
CTACGACTGGT -> TACGACTGGTA
CTACGCCACAA -> TACGCCACAAA
CTAGAACCCAG -> TAGAACCCAGT
CTAGAGTCATA -> TAGAGTCATAC
CTAGAGTCTGC -> TAGAGTCTGCT
CTAGATTTTGC -> TAGATTTTGCC
CTAGCTATAAG -> TAGCTATAAGA
CTAGGGATTCC -> TAGGGATTCCA
CTAGTCTTGGG -> TAGTCTTGGGA
CTAGTGTGTAG -> TAGTGTGTAGA
CTAGTTCCAGC -> TAGTTCCAGCG
CTATAAGACTT -> TATAAGACTTC
CTATACAGGAA -> TATACAGGAAT
CTATATTCTAC -> TATATTCTACC
CTATATTTGCA -> TATATTTGCAG
CTATCCAGCCT -> TATCCAGCCTT
CTATCTACAGT -> TATCTACAGTC
CTATCTGTGTA -> TATCTGTGTAG
CTATGCTTTCT -> TATGCTTTCTA
CTATTGCCCGC -> TATTGCCCGCG
CTATTTAGAAT -> TATTTAGAATA
CTATTTTGATG -> TATTTTGATGT
CTCACCAACGG -> TCACCAACGGT
CTCACGCCACG -> TCACGCCACGA
CTCAGCCCCGA -> TCAGCCCCGAA
CTCAGCTCATG -> TCAGCTCATGT
CTCAGGTAAGT -> TCAGGTAAGTT
CTCATGTACGC -> TCATGTACGCG
CTCCAGTATAT -> TCCAGTATATT
CTCCCCATAAA -> TCCCCATAAAC
CTCCCGGGTAA -> TCCCGGGTAAG
CTCCCTGGAGG -> TCCCTGGAGGA
CTCCGGGGGCC -> TCCGGGGGCCA
CTCCTTGGCTT -> TCCTTGGCTTA
CTCGATCCAGT -> TCGATCCAGTA
CTCGATTAAGG -> TCGATTAAGGA
CTCGTGTTGAT -> TCGTGTTGATG
CTCTACCTAAG -> TCTACCTAAGC
CTCTAGTGTGT -> TCTAGTGTGTA
CTCTCACGCCA -> TCTCACGCCAC
CTCTCTAGTGT -> TCTCTAGTGTG
CTCTGAAGTTG -> TCTGAAGTTGT
CTCTGCCTAAA -> TCTGCCTAAAG
CTCTGTGTTCA -> TCTGTGTTCAT
CTCTTCGCTTG -> TCTTCGCTTGC
CTGAACATCGA -> TGAACATCGAG
CTGAAGTTGTC -> TGAAGTTGTCT
CTGACATAGGG -> TGACATAGGGC
CTGAGGTAACC -> TGAGGTAACCG
CTGCACAAAAA -> TGCACAAAAAA
CTGCATTTGCA -> TGCATTTGCAA
CTGCCCGAAGA -> TGCCCGAAGAG
CTGCCTAAAGT -> TGCCTAAAGTA
CTGCCTCGATC -> TGCCTCGATCC
CTGCTAATGAG -> TGCTAATGAGA
CTGCTATCCAG -> TGCTATCCAGC
CTGCTATCTGT -> TGCTATCTGTG
CTGCTGTTGTT -> TGCTGTTGTTT
CTGCTTAACCC -> TGCTTAACCCG
CTGCTTGACCA -> TGCTTGACCAA
CTGGAAACCTC -> TGGAAACCTCT
CTGGAGGATCG -> TGGAGGATCGT
CTGGCGCACGT -> TGGCGCACGTA
CTGGTAATAAG -> TGGTAATAAGG
CTGTACCAACC -> TGTACCAACCT
CTGTATGATCC -> TGTATGATCCC
CTGTCCGGGTG -> TGTCCGGGTGT
CTGTCCGTATA -> TGTCCGTATAA
CTGTGTAGATC -> TGTGTAGATCT
CTGTGTTCATC -> TGTGTTCATCG
CTGTTGTTTAC -> TGTTGTTTACC
CTGTTTCGCCG -> TGTTTCGCCGA
CTTAAACGGCG -> TTAAACGGCGT
CTTAAACGTTA -> TTAAACGTTAG
CTTAAATAATG -> TTAAATAATGT
CTTAACCCGGC -> TTAACCCGGCA
CTTAGCCCGAG -> TTAGCCCGAGA
CTTAGGAGGCC -> TTAGGAGGCCT
CTTATAACCAC -> TTATAACCACC
CTTATCAGTGC -> TTATCAGTGCC
CTTATTAATAA -> TTATTAATAAG
CTTCATTTCTA -> TTCATTTCTAA
CTTCCGTTCCG -> TTCCGTTCCGA
CTTCCTCCCCA -> TTCCTCCCCAT
CTTCGCTTGCA -> TTCGCTTGCAA
CTTCGTACGAA -> TTCGTACGAAC
CTTCTAGAACC -> TTCTAGAACCC
CTTCTGAACAT -> TTCTGAACATC
CTTCTTAAATA -> TTCTTAAATAA
CTTGACCAACC -> TTGACCAACCC
CTTGATGGCGA -> TTGATGGCGAT
CTTGCAAAGCC -> TTGCAAAGCCT
CTTGGAGGCAT -> TTGGAGGCATG
CTTGGCTTATT -> TTGGCTTATTA
CTTGGGATTCC -> TTGGGATTCCT
CTTGGGGGTGT -> TTGGGGGTGTG
CTTTAGCAAAA -> TTTAGCAAAAA
CTTTATAGCTT -> TTTATAGCTTG
CTTTCCTTATA -> TTTCCTTATAA
CTTTCGAAGAC -> TTTCGAAGACA
CTTTCGCTGCC -> TTTCGCTGCCC
CTTTCTAGAGT -> TTTCTAGAGTC
CTTTCTCCGGG -> TTTCTCCGGGG
CTTTTACGCGG -> TTTTACGCGGC
GAAACCTCTTC -> AAACCTCTTCG
GAAAGCGGGGG -> AAAGCGGGGGG
GAAAGGATCCA -> AAAGGATCCAA
GAAAGTTGTTT -> AAAGTTGTTTT
GAAATCATATC -> AAATCATATCA
GAAATTCCGCT -> AAATTCCGCTA
GAACATCGAGT -> AACATCGAGTA
GAACCAAGGCG -> AACCAAGGCGC
GAACCCAGTCT -> AACCCAGTCTT
GAACTCCAGTA -> AACTCCAGTAT
GAACTCTACCT -> AACTCTACCTA
GAACTCTCTAG -> AACTCTCTAGT
GAAGAATTACT -> AAGAATTACTT
GAAGACACGAT -> AAGACACGATT
GAAGAGGTCGC -> AAGAGGTCGCA
GAAGATGGTGC -> AAGATGGTGCA
GAAGGAAAGGA -> AAGGAAAGGAT
GAAGGAGCTAA -> AAGGAGCTAAT
GAAGGCCGTTC -> AAGGCCGTTCC
GAAGGCTGTCC -> AAGGCTGTCCG
GAAGTTGTCTC -> AAGTTGTCTCT
GAATAATAGGC -> AATAATAGGCT
GAATATCTACG -> AATATCTACGA
GAATCGTTGCA -> AATCGTTGCAA
GAATGAGCGCC -> AATGAGCGCCA
GAATGCCCGAC -> AATGCCCGACG
GAATGGCAGCA -> AATGGCAGCAA
GAATGTTTAAT -> AATGTTTAATA
GAATTACTTAA -> AATTACTTAAA
GACAATAAACG -> ACAATAAACGC
GACAATAAGGG -> ACAATAAGGGC
GACAATTAAAA -> ACAATTAAAAA
GACACCAGGCT -> ACACCAGGCTT
GACACGATTGC -> ACACGATTGCA
GACACTTTAGC -> ACACTTTAGCA
GACAGAAGAAT -> ACAGAAGAATT
GACAGGACAAT -> ACAGGACAATT
GACATAGGGCA -> ACATAGGGCAC
GACCAACCCAG -> ACCAACCCAGC
GACCCGAATGT -> ACCCGAATGTT
GACCGACAGAA -> ACCGACAGAAG
GACCTTCATTT -> ACCTTCATTTC
GACGGCGCGAT -> ACGGCGCGATT
GACGGGTTCTA -> ACGGGTTCTAA
GACGGTCCAAG -> ACGGTCCAAGC
GACGTGAGCAC -> ACGTGAGCACC
GACGTTAGGTA -> ACGTTAGGTAT
GACGTTGAGCG -> ACGTTGAGCGT
GACTAGTCTTG -> ACTAGTCTTGG
GACTCACCAAC -> ACTCACCAACG
GACTCCCGGGT -> ACTCCCGGGTA
GACTCTGAAGT -> ACTCTGAAGTT
GACTCTGCCTA -> ACTCTGCCTAA
GACTGGTAATA -> ACTGGTAATAA
GACTTCGTACG -> ACTTCGTACGA
GAGAAATTCCG -> AGAAATTCCGC
GAGAATAATAG -> AGAATAATAGG
GAGAATGCCCG -> AGAATGCCCGA
GAGACACCAGG -> AGACACCAGGC
GAGACCCGAAT -> AGACCCGAATG
GAGACCTTCAT -> AGACCTTCATT
GAGACGTTAGG -> AGACGTTAGGT
GAGAGAGGCAC -> AGAGAGGCACA
GAGAGCTAGAG -> AGAGCTAGAGT
GAGAGGCACAA -> AGAGGCACAAG
GAGAGGCACTA -> AGAGGCACTAT
GAGATTACGTA -> AGATTACGTAC
GAGCACCGCGT -> AGCACCGCGTG
GAGCGAAGGAG -> AGCGAAGGAGC
GAGCGCCAGAG -> AGCGCCAGAGA
GAGCGTATAGC -> AGCGTATAGCA
GAGCGTCATTC -> AGCGTCATTCA
GAGCTAAAAAT -> AGCTAAAAATC
GAGCTAATTAT -> AGCTAATTATT
GAGCTAGAGTC -> AGCTAGAGTCT
GAGGATCGTCG -> AGGATCGTCGG
GAGGCACAAGT -> AGGCACAAGTT
GAGGCACTATG -> AGGCACTATGC
GAGGCATGCGT -> AGGCATGCGTT
GAGGCCTTATC -> AGGCCTTATCA
GAGGTAACCGC -> AGGTAACCGCT
GAGGTCGCAAG -> AGGTCGCAAGC
GAGTACTTAAA -> AGTACTTAAAC
GAGTAGTAAGC -> AGTAGTAAGCC
GAGTATGGCGC -> AGTATGGCGCA
GAGTCATACAT -> AGTCATACATG
GAGTCTGCTAA -> AGTCTGCTAAT
GAGTCTGCTTA -> AGTCTGCTTAA
GAGTGAGAGCT -> AGTGAGAGCTA
GATAACCATTT -> ATAACCATTTG
GATAAGAGCGT -> ATAAGAGCGTA
GATACCCGGCC -> ATACCCGGCCT
GATCATTTAGT -> ATCATTTAGTT
GATCCAAAGGG -> ATCCAAAGGGG
GATCCAGTATG -> ATCCAGTATGA
GATCCCCACTA -> ATCCCCACTAT
GATCCGGAACC -> ATCCGGAACCA
GATCGCTATAT -> ATCGCTATATT
GATCGGGAGAC -> ATCGGGAGACC
GATCGTCGGTG -> ATCGTCGGTGA
GATCTATTTAG -> ATCTATTTAGA
GATCTGCTATC -> ATCTGCTATCT
GATGACAATAA -> ATGACAATAAG
GATGCCACAAA -> ATGCCACAAAG
GATGGCGATTT -> ATGGCGATTTG
GATGGCGTACA -> ATGGCGTACAG
GATGGGACCGA -> ATGGGACCGAC
GATGGTGCAGC -> ATGGTGCAGCG
GATGGTGCGGG -> ATGGTGCGGGA
GATGTAAAAGG -> ATGTAAAAGGA
GATGTAGGGAC -> ATGTAGGGACT
GATGTGCCCGT -> ATGTGCCCGTC
GATTAAGGAAA -> ATTAAGGAAAT
GATTACGTACA -> ATTACGTACAT
GATTCCAGAAG -> ATTCCAGAAGG
GATTCCTAGTT -> ATTCCTAGTTC
GATTGCAACAG -> ATTGCAACAGG
GATTTAATCAA -> ATTTAATCAAT
GATTTGAACTC -> ATTTGAACTCC
GATTTGTTAGA -> ATTTGTTAGAT
GATTTTGCCTT -> ATTTTGCCTTG
GATTTTGCTAT -> ATTTTGCTATA
GCAAAAACTGA -> CAAAAACTGAG
GCAAAATTCTG -> CAAAATTCTGT
GCAAAGCCTGC -> CAAAGCCTGCC
GCAACAGGTTA -> CAACAGGTTAC
GCAACGCACTG -> CAACGCACTGT
GCAAGCATACG -> CAAGCATACGA
GCAAGCATCAC -> CAAGCATCACA
GCACAAAAAAA -> CACAAAAAAAG
GCACAAGTTAC -> CACAAGTTACT
GCACATGACTC -> CACATGACTCT
GCACCGCGTGT -> CACCGCGTGTT
GCACGATGGGA -> CACGATGGGAC
GCACGCCCTGC -> CACGCCCTGCA
GCACGTACGCC -> CACGTACGCCT
GCACTATGCTT -> CACTATGCTTT
GCACTCAGGTA -> CACTCAGGTAA
GCACTGCACAA -> CACTGCACAAA
GCACTGTATGA -> CACTGTATGAT
GCACTTCTGAA -> CACTTCTGAAC
GCAGAGCGAAG -> CAGAGCGAAGG
GCAGATCGCTA -> CAGATCGCTAT
GCAGATGTGCC -> CAGATGTGCCC
GCAGCAAAATT -> CAGCAAAATTC
GCAGCGTAGCA -> CAGCGTAGCAT
GCAGTAAGAGA -> CAGTAAGAGAA
GCATACGATCT -> CATACGATCTG
GCATAGCGCGT -> CATAGCGCGTC
GCATCACATGA -> CATCACATGAC
GCATCACTACC -> CATCACTACCA
GCATCAGCAGA -> CATCAGCAGAT
GCATGCGTTCC -> CATGCGTTCCG
GCATGTATCCA -> CATGTATCCAG
GCATTGCGTTA -> CATTGCGTTAC
GCATTTGCAAC -> CATTTGCAACG
GCCACAAAGGC -> CCACAAAGGCG
GCCACAAAGGT -> CCACAAAGGTG
GCCACATAGGT -> CCACATAGGTT
GCCACGATCGG -> CCACGATCGGG
GCCAGAGACCC -> CCAGAGACCCG
GCCAGGATCAT -> CCAGGATCATT
GCCATGACGGT -> CCATGACGGTC
GCCCACCGAAG -> CCCACCGAAGG
GCCCCGAAAGC -> CCCCGAAAGCG
GCCCCTTCTAG -> CCCCTTCTAGA
GCCCGAAGAGG -> CCCGAAGAGGT
GCCCGACGGGT -> CCCGACGGGTT
GCCCGAGATTA -> CCCGAGATTAC
GCCCGCGGCCG -> CCCGCGGCCGG
GCCCGTCGTAC -> CCCGTCGTACT
GCCCTGCATTT -> CCCTGCATTTG
GCCGACTCTGC -> CCGACTCTGCC
GCCGGCTCAGC -> CCGGCTCAGCT
GCCGGTACGAC -> CCGGTACGACT
GCCGTTCACGC -> CCGTTCACGCC
GCCGTTCCGGA -> CCGTTCCGGAC
GCCGTTCGGCG -> CCGTTCGGCGG
GCCTAAAGTAG -> CCTAAAGTAGG
GCCTCGATCCA -> CCTCGATCCAG
GCCTCTCACGC -> CCTCTCACGCC
GCCTGCCTCGA -> CCTGCCTCGAT
GCCTGCTGTTG -> CCTGCTGTTGT
GCCTTATCAGT -> CCTTATCAGTG
GCCTTCTTAAA -> CCTTCTTAAAT
GCCTTGGGGGT -> CCTTGGGGGTG
GCCTTTTACGC -> CCTTTTACGCG
GCGAAGGAGCT -> CGAAGGAGCTA
GCGAATGGCAG -> CGAATGGCAGC
GCGACGGCGCG -> CGACGGCGCGA
GCGAGACACCA -> CGAGACACCAG
GCGAGTAGTAA -> CGAGTAGTAAG
GCGATTTGTTA -> CGATTTGTTAG
GCGATTTTGCT -> CGATTTTGCTA
GCGCACATGAC -> CGCACATGACT
GCGCACGTACG -> CGCACGTACGC
GCGCACTGCAC -> CGCACTGCACA
GCGCATCACTA -> CGCATCACTAC
GCGCCAGAGAC -> CGCCAGAGACC
GCGCGATTTTG -> CGCGATTTTGC
GCGCGCACTGC -> CGCGCACTGCA
GCGCGTCTTTC -> CGCGTCTTTCG
GCGCTCAGCCC -> CGCTCAGCCCC
GCGGCCCCTTC -> CGGCCCCTTCT
GCGGCCGGTAC -> CGGCCGGTACG
GCGGCCGTTCA -> CGGCCGTTCAC
GCGGCCGTTCG -> CGGCCGTTCGG
GCGGCGGGGAC -> CGGCGGGGACA
GCGGGACTCAC -> CGGGACTCACC
GCGGGGACACT -> CGGGGACACTT
GCGGGGGGCTT -> CGGGGGGCTTC
GCGGTGAATCG -> CGGTGAATCGT
GCGTACAGAGA -> CGTACAGAGAA
GCGTACAGAGT -> CGTACAGAGTA
GCGTAGCATAG -> CGTAGCATAGC
GCGTATAGCAT -> CGTATAGCATT
GCGTCATCAGT -> CGTCATCAGTC
GCGTCATTCAT -> CGTCATTCATT
GCGTCTTTCGC -> CGTCTTTCGCT
GCGTGTAATCT -> CGTGTAATCTC
GCGTGTAGCGG -> CGTGTAGCGGC
GCGTGTTGGGG -> CGTGTTGGGGT
GCGTTACGTGT -> CGTTACGTGTG
GCGTTCAGGTC -> CGTTCAGGTCT
GCGTTCCGCGG -> CGTTCCGCGGC
GCTAAAAATCC -> CTAAAAATCCT
GCTAATGAGAG -> CTAATGAGAGG
GCTAGAGTCTG -> CTAGAGTCTGC
GCTAGATTTTG -> CTAGATTTTGC
GCTAGCTATAA -> CTAGCTATAAG
GCTATAAGACT -> CTATAAGACTT
GCTATATTCTA -> CTATATTCTAC
GCTATATTTGC -> CTATATTTGCA
GCTATCCAGCC -> CTATCCAGCCT
GCTATCTACAG -> CTATCTACAGT
GCTATCTGTGT -> CTATCTGTGTA
GCTCAGCCCCG -> CTCAGCCCCGA
GCTCAGCTCAT -> CTCAGCTCATG
GCTCATGTACG -> CTCATGTACGC
GCTCGTGTTGA -> CTCGTGTTGAT
GCTGCCCGAAG -> CTGCCCGAAGA
GCTGTCCGTAT -> CTGTCCGTATA
GCTGTTGTTTA -> CTGTTGTTTAC
GCTTAACCCGG -> CTTAACCCGGC
GCTTAGCCCGA -> CTTAGCCCGAG
GCTTATTAATA -> CTTATTAATAA
GCTTCCTCCCC -> CTTCCTCCCCA
GCTTGACCAAC -> CTTGACCAACC
GCTTGATGGCG -> CTTGATGGCGA
GCTTGCAAAGC -> CTTGCAAAGCC
GCTTGGAGGCA -> CTTGGAGGCAT
GCTTTCTAGAG -> CTTTCTAGAGT
GCTTTCTCCGG -> CTTTCTCCGGG
GGAAACCTCTT -> GAAACCTCTTC
GGAAAGGATCC -> GAAAGGATCCA
GGAAATCATAT -> GAAATCATATC
GGAACCAAGGC -> GAACCAAGGCG
GGAATGAGCGC -> GAATGAGCGCC
GGACAATTAAA -> GACAATTAAAA
GGACACTTTAG -> GACACTTTAGC
GGACAGGACAA -> GACAGGACAAT
GGACCGACAGA -> GACCGACAGAA
GGACGTGAGCA -> GACGTGAGCAC
GGACTCACCAA -> GACTCACCAAC
GGACTCCCGGG -> GACTCCCGGGT
GGAGACCTTCA -> GAGACCTTCAT
GGAGCTAATTA -> GAGCTAATTAT
GGAGGATCGTC -> GAGGATCGTCG
GGAGGCATGCG -> GAGGCATGCGT
GGAGGCCTTAT -> GAGGCCTTATC
GGATACCCGGC -> GATACCCGGCC
GGATCATTTAG -> GATCATTTAGT
GGATCCAAAGG -> GATCCAAAGGG
GGATCGTCGGT -> GATCGTCGGTG
GGATGGCGTAC -> GATGGCGTACA
GGATGGTGCGG -> GATGGTGCGGG
GGATTCCAGAA -> GATTCCAGAAG
GGATTCCTAGT -> GATTCCTAGTT
GGCACAAGTTA -> GCACAAGTTAC
GGCACGCCCTG -> GCACGCCCTGC
GGCACTATGCT -> GCACTATGCTT
GGCACTTCTGA -> GCACTTCTGAA
GGCAGAGCGAA -> GCAGAGCGAAG
GGCAGCAAAAT -> GCAGCAAAATT
GGCATGCGTTC -> GCATGCGTTCC
GGCATGTATCC -> GCATGTATCCA
GGCCATGACGG -> GCCATGACGGT
GGCCCCTTCTA -> GCCCCTTCTAG
GGCCGGTACGA -> GCCGGTACGAC
GGCCGTTCACG -> GCCGTTCACGC
GGCCGTTCCGG -> GCCGTTCCGGA
GGCCGTTCGGC -> GCCGTTCGGCG
GGCCTTATCAG -> GCCTTATCAGT
GGCCTTTTACG -> GCCTTTTACGC
GGCGAATGGCA -> GCGAATGGCAG
GGCGAGACACC -> GCGAGACACCA
GGCGAGTAGTA -> GCGAGTAGTAA
GGCGATTTGTT -> GCGATTTGTTA
GGCGCACGTAC -> GCGCACGTACG
GGCGCATCACT -> GCGCATCACTA
GGCGCGATTTT -> GCGCGATTTTG
GGCGCGCACTG -> GCGCGCACTGC
GGCGGCGGGGA -> GCGGCGGGGAC
GGCGGGGACAC -> GCGGGGACACT
GGCGTACAGAG -> GCGTACAGAGA
GGCGTCATCAG -> GCGTCATCAGT
GGCTCAGCTCA -> GCTCAGCTCAT
GGCTCGTGTTG -> GCTCGTGTTGA
GGCTGTCCGTA -> GCTGTCCGTAT
GGCTTAGCCCG -> GCTTAGCCCGA
GGCTTATTAAT -> GCTTATTAATA
GGCTTCCTCCC -> GCTTCCTCCCC
GGCTTGATGGC -> GCTTGATGGCG
GGCTTTCTCCG -> GCTTTCTCCGG
GGGACACTTTA -> GGACACTTTAG
GGGACCGACAG -> GGACCGACAGA
GGGACTCACCA -> GGACTCACCAA
GGGACTCCCGG -> GGACTCCCGGG
GGGAGACCTTC -> GGAGACCTTCA
GGGATGGTGCG -> GGATGGTGCGG
GGGATTCCAGA -> GGATTCCAGAA
GGGATTCCTAG -> GGATTCCTAGT
GGGCACGCCCT -> GGCACGCCCTG
GGGCAGAGCGA -> GGCAGAGCGAA
GGGCCATGACG -> GGCCATGACGG
GGGCGAATGGC -> GGCGAATGGCA
GGGCTTCCTCC -> GGCTTCCTCCC
GGGGACACTTT -> GGGACACTTTA
GGGGCCATGAC -> GGGCCATGACG
GGGGCTTCCTC -> GGGCTTCCTCC
GGGGGCCATGA -> GGGGCCATGAC
GGGGGCTTCCT -> GGGGCTTCCTC
GGGGGGCTTCC -> GGGGGCTTCCT
GGGGGTGTGTA -> GGGGTGTGTAT
GGGGTACAGAC -> GGGTACAGACA
GGGGTGGGATG -> GGGTGGGATGG
GGGGTGTGTAT -> GGGTGTGTATC
GGGTAAGATGC -> GGTAAGATGCC
GGGTACAGACA -> GGTACAGACAA
GGGTGGGATGG -> GGTGGGATGGT
GGGTGTCGTAT -> GGTGTCGTATG
GGGTGTGTATC -> GGTGTGTATCT
GGGTTCTAATC -> GGTTCTAATCC
GGGTTGCGGTG -> GGTTGCGGTGA
GGTAACCGCTA -> GTAACCGCTAG
GGTAAGATGCC -> GTAAGATGCCA
GGTAAGTTGAG -> GTAAGTTGAGA
GGTAATAAGGT -> GTAATAAGGTT
GGTACAGACAA -> GTACAGACAAT
GGTACGACTAG -> GTACGACTAGT
GGTATCAGCGC -> GTATCAGCGCT
GGTCAGGTTTG -> GTCAGGTTTGA
GGTCCAAGCGT -> GTCCAAGCGTT
GGTCGCAAGCA -> GTCGCAAGCAT
GGTCTATACAG -> GTCTATACAGG
GGTGAAGGCTG -> GTGAAGGCTGT
GGTGAATCGTT -> GTGAATCGTTG
GGTGATGACAA -> GTGATGACAAT
GGTGCAGCGTA -> GTGCAGCGTAG
GGTGCGGGACT -> GTGCGGGACTC
GGTGGCACTTC -> GTGGCACTTCT
GGTGGGATGGT -> GTGGGATGGTG
GGTGGTCAGGT -> GTGGTCAGGTT
GGTGTCGTATG -> GTGTCGTATGT
GGTGTGTATCT -> GTGTGTATCTA
GGTTACCTTCC -> GTTACCTTCCG
GGTTATGGTGG -> GTTATGGTGGC
GGTTCACCGCA -> GTTCACCGCAC
GGTTCATGCAG -> GTTCATGCAGA
GGTTCTAATCC -> GTTCTAATCCA
GGTTCTGTACC -> GTTCTGTACCA
GGTTCTTTATA -> GTTCTTTATAG
GGTTGCGGTGA -> GTTGCGGTGAA
GGTTTGAGAAT -> GTTTGAGAATG
GTAAAAGGATG -> TAAAAGGATGG
GTAACCGCTAG -> TAACCGCTAGC
GTAAGAGAATA -> TAAGAGAATAA
GTAAGATGCCA -> TAAGATGCCAC
GTAAGCCCACC -> TAAGCCCACCG
GTAAGTTGAGA -> TAAGTTGAGAC
GTAATAAGGTT -> TAATAAGGTTC
GTAATACCGAG -> TAATACCGAGT
GTAATCTCCTT -> TAATCTCCTTG
GTACAGACAAT -> TACAGACAATA
GTACAGAGAAA -> TACAGAGAAAT
GTACAGAGTAT -> TACAGAGTATG
GTACATTCTTT -> TACATTCTTTC
GTACCAACCTG -> TACCAACCTGG
GTACGAACTCT -> TACGAACTCTC
GTACGACTAGT -> TACGACTAGTC
GTACGCCTCTC -> TACGCCTCTCA
GTACGCGTGTA -> TACGCGTGTAA
GTACTACAACA -> TACTACAACAA
GTACTTAAACG -> TACTTAAACGG
GTAGAGTGAGA -> TAGAGTGAGAG
GTAGATCTATT -> TAGATCTATTT
GTAGCATAGCG -> TAGCATAGCGC
GTAGCGGCCCC -> TAGCGGCCCCT
GTAGGACAGGA -> TAGGACAGGAC
GTAGGGACTCC -> TAGGGACTCCC
GTAGGTTATGG -> TAGGTTATGGT
GTAGTAAGCCC -> TAGTAAGCCCA
GTATAACCGGG -> TATAACCGGGC
GTATAGCATTG -> TATAGCATTGC
GTATAGCGTAC -> TATAGCGTACA
GTATATTAACT -> TATATTAACTG
GTATCAGCGCT -> TATCAGCGCTC
GTATCCAGTTG -> TATCCAGTTGT
GTATCCTGCTT -> TATCCTGCTTG
GTATCTAGGGA -> TATCTAGGGAT
GTATGATAAGA -> TATGATAAGAG
GTATGATCCCC -> TATGATCCCCA
GTATGGCGCAT -> TATGGCGCATC
GTATGTGCGCA -> TATGTGCGCAC
GTCAACCCGTT -> TCAACCCGTTT
GTCACCGTCAT -> TCACCGTCATG
GTCAGGTTTGA -> TCAGGTTTGAG
GTCATACATGT -> TCATACATGTA
GTCATCAGTCT -> TCATCAGTCTC
GTCATGGTTCT -> TCATGGTTCTG
GTCATTCATTC -> TCATTCATTCA
GTCCAAGCGTT -> TCCAAGCGTTC
GTCCGGGTGTC -> TCCGGGTGTCG
GTCCGTATAAC -> TCCGTATAACC
GTCGCAAGCAT -> TCGCAAGCATC
GTCGGTGATGA -> TCGGTGATGAC
GTCGTACTACA -> TCGTACTACAA
GTCGTATGTGC -> TCGTATGTGCG
GTCTATACAGG -> TCTATACAGGA
GTCTCGATTAA -> TCTCGATTAAG
GTCTCTGTGTT -> TCTCTGTGTTC
GTCTGCTAATG -> TCTGCTAATGA
GTCTGCTTAAC -> TCTGCTTAACC
GTCTTGGGATT -> TCTTGGGATTC
GTCTTTCGAAG -> TCTTTCGAAGA
GTCTTTCGCTG -> TCTTTCGCTGC
GTGAAGGCTGT -> TGAAGGCTGTC
GTGAATCGTTG -> TGAATCGTTGC
GTGAGAGCTAG -> TGAGAGCTAGA
GTGAGCACCGC -> TGAGCACCGCG
GTGATGACAAT -> TGATGACAATA
GTGCAGCGTAG -> TGCAGCGTAGC
GTGCATCAGCA -> TGCATCAGCAG
GTGCCACATAG -> TGCCACATAGG
GTGCCCGTCGT -> TGCCCGTCGTA
GTGCGCACATG -> TGCGCACATGA
GTGCGGGACTC -> TGCGGGACTCA
GTGGCACTTCT -> TGGCACTTCTG
GTGGCTCGTGT -> TGGCTCGTGTT
GTGGGATGGTG -> TGGGATGGTGC
GTGGGTTGCGG -> TGGGTTGCGGT
GTGGTCAGGTT -> TGGTCAGGTTT
GTGTAATCTCC -> TGTAATCTCCT
GTGTAGAGTGA -> TGTAGAGTGAG
GTGTAGATCTA -> TGTAGATCTAT
GTGTAGCGGCC -> TGTAGCGGCCC
GTGTATCTAGG -> TGTATCTAGGG
GTGTCGTATGT -> TGTCGTATGTG
GTGTGCATCAG -> TGTGCATCAGC
GTGTGTAGAGT -> TGTGTAGAGTG
GTGTGTATCTA -> TGTGTATCTAG
GTGTTCATCGT -> TGTTCATCGTG
GTGTTGATGTA -> TGTTGATGTAG
GTGTTGGGGTA -> TGTTGGGGTAC
GTTACCTTCCG -> TTACCTTCCGT
GTTACGTGTGC -> TTACGTGTGCA
GTTACTGTCCG -> TTACTGTCCGG
GTTAGATTTGA -> TTAGATTTGAA
GTTAGGCGAGT -> TTAGGCGAGTA
GTTAGGTATCA -> TTAGGTATCAG
GTTATGGTGGC -> TTATGGTGGCA
GTTCACCGCAC -> TTCACCGCACG
GTTCACGCCAG -> TTCACGCCAGG
GTTCAGGTCTA -> TTCAGGTCTAT
GTTCATCGTGG -> TTCATCGTGGG
GTTCATGCAGA -> TTCATGCAGAT
GTTCCAGCGAC -> TTCCAGCGACG
GTTCCGATAAC -> TTCCGATAACC
GTTCCGCGGCC -> TTCCGCGGCCG
GTTCCGGACGT -> TTCCGGACGTG
GTTCGGCGGCG -> TTCGGCGGCGG
GTTCTAATCCA -> TTCTAATCCAT
GTTCTAATCTG -> TTCTAATCTGG
GTTCTGTACCA -> TTCTGTACCAA
GTTCTTTATAG -> TTCTTTATAGC
GTTGAGACGTT -> TTGAGACGTTA
GTTGAGCGTCA -> TTGAGCGTCAT
GTTGATGTAGG -> TTGATGTAGGG
GTTGCAAGCAT -> TTGCAAGCATA
GTTGCGGTGAA -> TTGCGGTGAAT
GTTGGGGTACA -> TTGGGGTACAG
GTTGTCTCTGT -> TTGTCTCTGTG
GTTGTGGCTCG -> TTGTGGCTCGT
GTTGTTTACCC -> TTGTTTACCCT
GTTGTTTTTGT -> TTGTTTTTGTA
GTTTAATAAAG -> TTTAATAAAGA
GTTTACCCTCC -> TTTACCCTCCC
GTTTCGCCGAC -> TTTCGCCGACT
GTTTGAAAGTT -> TTTGAAAGTTG
GTTTGAGAATG -> TTTGAGAATGC
GTTTTTGTATA -> TTTTTGTATAG
TAAAAACGTAT -> AAAAACGTATC
TAAAAATCCTT -> AAAAATCCTTA
TAAAAGGATGG -> AAAAGGATGGC
TAAACGAGAGA -> AAACGAGAGAG
TAAACGCCGGC -> AAACGCCGGCT
TAAACGGCGTC -> AAACGGCGTCA
TAAACGTTAGG -> AAACGTTAGGC
TAAACTATTGC -> AAACTATTGCC
TAAAGATTTAA -> AAAGATTTAAT
TAAAGTAGGTT -> AAAGTAGGTTA
TAAATAATGTA -> AAATAATGTAA
TAACCACCCGC -> AACCACCCGCT
TAACCATTTGG -> AACCATTTGGT
TAACCCGGCAT -> AACCCGGCATG
TAACCGCTAGC -> AACCGCTAGCT
TAACCGGGCGA -> AACCGGGCGAA
TAACTGACATA -> AACTGACATAG
TAAGACTTCGT -> AAGACTTCGTA
TAAGAGAATAA -> AAGAGAATAAT
TAAGAGCGTAT -> AAGAGCGTATA
TAAGATCCGGA -> AAGATCCGGAA
TAAGATGCCAC -> AAGATGCCACA
TAAGCCCACCG -> AAGCCCACCGA
TAAGCCTGCTG -> AAGCCTGCTGT
TAAGGAAATCA -> AAGGAAATCAT
TAAGGGCAGAG -> AAGGGCAGAGC
TAAGGTTCACC -> AAGGTTCACCG
TAAGTTGAGAC -> AAGTTGAGACG
TAATAAAGATT -> AATAAAGATTT
TAATAAGATCC -> AATAAGATCCG
TAATAAGGTTC -> AATAAGGTTCA
TAATACCGAGT -> AATACCGAGTC
TAATAGGCTTG -> AATAGGCTTGA
TAATCAATCGT -> AATCAATCGTC
TAATCCATGGA -> AATCCATGGAT
TAATCTCCTTG -> AATCTCCTTGG
TAATCTGGAAA -> AATCTGGAAAC
TAATGAGAGGC -> AATGAGAGGCA
TAATGTAATAC -> AATGTAATACC
TACAACAAGCA -> ACAACAAGCAC
TACACTGCTAT -> ACACTGCTATC
TACAGACAATA -> ACAGACAATAA
TACAGAGAAAT -> ACAGAGAAATT
TACAGAGTATG -> ACAGAGTATGG
TACAGGAATGA -> ACAGGAATGAG
TACAGTCACCG -> ACAGTCACCGT
TACATGTAGGA -> ACATGTAGGAC
TACATTCTTTC -> ACATTCTTTCC
TACCAACCTGG -> ACCAACCTGGC
TACCATCCTAC -> ACCATCCTACG
TACCCGGCCTT -> ACCCGGCCTTT
TACCCTCCCTG -> ACCCTCCCTGG
TACCGAAGATG -> ACCGAAGATGG
TACCGAGTCTG -> ACCGAGTCTGC
TACCTAAGCCT -> ACCTAAGCCTG
TACCTTCCGTT -> ACCTTCCGTTC
TACGAACTCTC -> ACGAACTCTCT
TACGACTAGTC -> ACGACTAGTCT
TACGACTGGTA -> ACGACTGGTAA
TACGATCTGCT -> ACGATCTGCTA
TACGCCACAAA -> ACGCCACAAAG
TACGCCTCTCA -> ACGCCTCTCAC
TACGCGGCCGT -> ACGCGGCCGTT
TACGCGTGTAA -> ACGCGTGTAAT
TACGTACATTC -> ACGTACATTCT
TACGTGTGCAT -> ACGTGTGCATC
TACTACAACAA -> ACTACAACAAG
TACTGTCCGGG -> ACTGTCCGGGT
TACTTAAACGG -> ACTTAAACGGC
TACTTAAACGT -> ACTTAAACGTT
TAGAACCCAGT -> AGAACCCAGTC
TAGAATATCTA -> AGAATATCTAC
TAGAGTCATAC -> AGAGTCATACA
TAGAGTCTGCT -> AGAGTCTGCTA
TAGAGTGAGAG -> AGAGTGAGAGC
TAGATCTATTT -> AGATCTATTTA
TAGATTTGAAC -> AGATTTGAACT
TAGATTTTGCC -> AGATTTTGCCT
TAGCAAAAACT -> AGCAAAAACTG
TAGCATAGCGC -> AGCATAGCGCG
TAGCATTGCGT -> AGCATTGCGTT
TAGCCCGAGAT -> AGCCCGAGATT
TAGCGCGTCTT -> AGCGCGTCTTT
TAGCGGCCCCT -> AGCGGCCCCTT
TAGCGTACAGA -> AGCGTACAGAG
TAGCTATAAGA -> AGCTATAAGAC
TAGCTTGGAGG -> AGCTTGGAGGC
TAGGACAGGAC -> AGGACAGGACA
TAGGAGGCCTT -> AGGAGGCCTTA
TAGGCGAGTAG -> AGGCGAGTAGT
TAGGCTTGATG -> AGGCTTGATGG
TAGGGACTCCC -> AGGGACTCCCG
TAGGGATTCCA -> AGGGATTCCAG
TAGGGCACGCC -> AGGGCACGCCC
TAGGTATCAGC -> AGGTATCAGCG
TAGGTTATGGT -> AGGTTATGGTG
TAGGTTCTTTA -> AGGTTCTTTAT
TAGTAAGCCCA -> AGTAAGCCCAC
TAGTCTTGGGA -> AGTCTTGGGAT
TAGTGTGTAGA -> AGTGTGTAGAG
TAGTTCCAGCG -> AGTTCCAGCGA
TAGTTCTAATC -> AGTTCTAATCT
TATAACCACCC -> ATAACCACCCG
TATAACCGGGC -> ATAACCGGGCG
TATAAGACTTC -> ATAAGACTTCG
TATACAGGAAT -> ATACAGGAATG
TATAGCATTGC -> ATAGCATTGCG
TATAGCGTACA -> ATAGCGTACAG
TATAGCTTGGA -> ATAGCTTGGAG
TATATTAACTG -> ATATTAACTGA
TATATTCTACC -> ATATTCTACCG
TATATTTGCAG -> ATATTTGCAGT
TATCACAATAC -> ATCACAATACA
TATCAGCGCTC -> ATCAGCGCTCA
TATCAGTGCCA -> ATCAGTGCCAC
TATCCAGCCTT -> ATCCAGCCTTC
TATCCAGTTGT -> ATCCAGTTGTG
TATCCTGCTTG -> ATCCTGCTTGA
TATCTACAGTC -> ATCTACAGTCA
TATCTACGACT -> ATCTACGACTG
TATCTAGGGAT -> ATCTAGGGATT
TATCTGTGTAG -> ATCTGTGTAGA
TATGATAAGAG -> ATGATAAGAGC
TATGATCCCCA -> ATGATCCCCAC
TATGCTTTCTA -> ATGCTTTCTAG
TATGGCGCATC -> ATGGCGCATCA
TATGGTGGCAC -> ATGGTGGCACT
TATGTGCGCAC -> ATGTGCGCACA
TATTAACTGAC -> ATTAACTGACA
TATTAATAAGA -> ATTAATAAGAT
TATTCTACCGA -> ATTCTACCGAA
TATTGCCCGCG -> ATTGCCCGCGG
TATTTAGAATA -> ATTTAGAATAT
TATTTGCAGTA -> ATTTGCAGTAA
TATTTTGATGT -> ATTTTGATGTA
TCAACCCGTTT -> CAACCCGTTTG
TCAATCGTCAA -> CAATCGTCAAC
TCACAATACAC -> CACAATACACT
TCACATGACGT -> CACATGACGTT
TCACCAACGGT -> CACCAACGGTT
TCACCGCACGA -> CACCGCACGAT
TCACCGTCATG -> CACCGTCATGG
TCACGAGCTAA -> CACGAGCTAAA
TCACGCCACGA -> CACGCCACGAT
TCACGCCAGGA -> CACGCCAGGAT
TCACTACCATC -> CACTACCATCC
TCAGCAGATGT -> CAGCAGATGTG
TCAGCCCCGAA -> CAGCCCCGAAA
TCAGCGCTCAG -> CAGCGCTCAGC
TCAGCTCATGT -> CAGCTCATGTA
TCAGGTAAGTT -> CAGGTAAGTTG
TCAGGTCTATA -> CAGGTCTATAC
TCAGGTTTGAG -> CAGGTTTGAGA
TCAGTCTCGAT -> CAGTCTCGATT
TCAGTGCCACA -> CAGTGCCACAT
TCATACATGTA -> CATACATGTAG
TCATATCACAA -> CATATCACAAT
TCATCAGTCTC -> CATCAGTCTCG
TCATCGTGGGT -> CATCGTGGGTT
TCATGCAGATC -> CATGCAGATCG
TCATGGTTCTG -> CATGGTTCTGT
TCATGTACGCG -> CATGTACGCGT
TCATTCACGAG -> CATTCACGAGC
TCATTCATTCA -> CATTCATTCAC
TCATTTAGTTC -> CATTTAGTTCT
TCATTTCTAAA -> CATTTCTAAAC
TCCAAAGGGGT -> CCAAAGGGGTG
TCCAAGCGTTC -> CCAAGCGTTCA
TCCAGAAGGAA -> CCAGAAGGAAA
TCCAGCCTTCT -> CCAGCCTTCTT
TCCAGCGACGG -> CCAGCGACGGC
TCCAGTATATT -> CCAGTATATTA
TCCAGTATGAT -> CCAGTATGATA
TCCAGTTGTGG -> CCAGTTGTGGC
TCCATGGATAC -> CCATGGATACC
TCCCCACTATT -> CCCCACTATTT
TCCCCATAAAC -> CCCCATAAACT
TCCCGGGTAAG -> CCCGGGTAAGA
TCCCTGGAGGA -> CCCTGGAGGAT
TCCGATAACCA -> CCGATAACCAT
TCCGCGGCCGT -> CCGCGGCCGTT
TCCGCTAGATT -> CCGCTAGATTT
TCCGGAACCAA -> CCGGAACCAAG
TCCGGACGTGA -> CCGGACGTGAG
TCCGGGGGCCA -> CCGGGGGCCAT
TCCGGGTGTCG -> CCGGGTGTCGT
TCCGTATAACC -> CCGTATAACCG
TCCGTTCCGAT -> CCGTTCCGATA
TCCTACGCCAC -> CCTACGCCACA
TCCTAGTTCCA -> CCTAGTTCCAG
TCCTCCCCATA -> CCTCCCCATAA
TCCTGCTTGAC -> CCTGCTTGACC
TCCTTAGGAGG -> CCTTAGGAGGC
TCCTTATAACC -> CCTTATAACCA
TCCTTGGCTTA -> CCTTGGCTTAT
TCGAAGACACG -> CGAAGACACGA
TCGAGTACTTA -> CGAGTACTTAA
TCGATCCAGTA -> CGATCCAGTAT
TCGATTAAGGA -> CGATTAAGGAA
TCGCAAGCATC -> CGCAAGCATCA
TCGCCGACTCT -> CGCCGACTCTG
TCGCTATATTC -> CGCTATATTCT
TCGCTGCCCGA -> CGCTGCCCGAA
TCGCTTGCAAA -> CGCTTGCAAAG
TCGGCGGCGGG -> CGGCGGCGGGG
TCGGGAGACCT -> CGGGAGACCTT
TCGGTGATGAC -> CGGTGATGACA
TCGTACGAACT -> CGTACGAACTC
TCGTACTACAA -> CGTACTACAAC
TCGTATGTGCG -> CGTATGTGCGC
TCGTCAACCCG -> CGTCAACCCGT
TCGTCGGTGAT -> CGTCGGTGATG
TCGTGGGTTGC -> CGTGGGTTGCG
TCGTGTTGATG -> CGTGTTGATGT
TCGTTGCAAGC -> CGTTGCAAGCA
TCTAAACGAGA -> CTAAACGAGAG
TCTAATCCATG -> CTAATCCATGG
TCTAATCTGGA -> CTAATCTGGAA
TCTACAGTCAC -> CTACAGTCACC
TCTACCGAAGA -> CTACCGAAGAT
TCTACCTAAGC -> CTACCTAAGCC
TCTACGACTGG -> CTACGACTGGT
TCTAGAACCCA -> CTAGAACCCAG
TCTAGAGTCAT -> CTAGAGTCATA
TCTAGGGATTC -> CTAGGGATTCC
TCTAGTGTGTA -> CTAGTGTGTAG
TCTATACAGGA -> CTATACAGGAA
TCTATTTAGAA -> CTATTTAGAAT
TCTCACGCCAC -> CTCACGCCACG
TCTCCGGGGGC -> CTCCGGGGGCC
TCTCCTTGGCT -> CTCCTTGGCTT
TCTCGATTAAG -> CTCGATTAAGG
TCTCTAGTGTG -> CTCTAGTGTGT
TCTCTGTGTTC -> CTCTGTGTTCA
TCTGAACATCG -> CTGAACATCGA
TCTGAAGTTGT -> CTGAAGTTGTC
TCTGCCTAAAG -> CTGCCTAAAGT
TCTGCTAATGA -> CTGCTAATGAG
TCTGCTATCTG -> CTGCTATCTGT
TCTGCTTAACC -> CTGCTTAACCC
TCTGGAAACCT -> CTGGAAACCTC
TCTGTACCAAC -> CTGTACCAACC
TCTGTGTAGAT -> CTGTGTAGATC
TCTGTGTTCAT -> CTGTGTTCATC
TCTGTTTCGCC -> CTGTTTCGCCG
TCTTAAATAAT -> CTTAAATAATG
TCTTCGCTTGC -> CTTCGCTTGCA
TCTTGGGATTC -> CTTGGGATTCC
TCTTTATAGCT -> CTTTATAGCTT
TCTTTCCTTAT -> CTTTCCTTATA
TCTTTCGAAGA -> CTTTCGAAGAC
TCTTTCGCTGC -> CTTTCGCTGCC
TGAAAGTTGTT -> GAAAGTTGTTT
TGAACATCGAG -> GAACATCGAGT
TGAACTCCAGT -> GAACTCCAGTA
TGAAGGCTGTC -> GAAGGCTGTCC
TGAAGTTGTCT -> GAAGTTGTCTC
TGAATCGTTGC -> GAATCGTTGCA
TGACAATAAGG -> GACAATAAGGG
TGACATAGGGC -> GACATAGGGCA
TGACCAACCCA -> GACCAACCCAG
TGACGGTCCAA -> GACGGTCCAAG
TGACGTTGAGC -> GACGTTGAGCG
TGACTCTGAAG -> GACTCTGAAGT
TGAGAATGCCC -> GAGAATGCCCG
TGAGACGTTAG -> GAGACGTTAGG
TGAGAGCTAGA -> GAGAGCTAGAG
TGAGAGGCACT -> GAGAGGCACTA
TGAGCACCGCG -> GAGCACCGCGT
TGAGCGCCAGA -> GAGCGCCAGAG
TGAGCGTCATT -> GAGCGTCATTC
TGAGGTAACCG -> GAGGTAACCGC
TGATAAGAGCG -> GATAAGAGCGT
TGATCCCCACT -> GATCCCCACTA
TGATGACAATA -> GATGACAATAA
TGATGGCGATT -> GATGGCGATTT
TGATGTAAAAG -> GATGTAAAAGG
TGATGTAGGGA -> GATGTAGGGAC
TGCAAAGCCTG -> GCAAAGCCTGC
TGCAACAGGTT -> GCAACAGGTTA
TGCAACGCACT -> GCAACGCACTG
TGCAAGCATAC -> GCAAGCATACG
TGCACAAAAAA -> GCACAAAAAAA
TGCAGATCGCT -> GCAGATCGCTA
TGCAGCGTAGC -> GCAGCGTAGCA
TGCAGTAAGAG -> GCAGTAAGAGA
TGCATCAGCAG -> GCATCAGCAGA
TGCATTTGCAA -> GCATTTGCAAC
TGCCACAAAGG -> GCCACAAAGGC
TGCCACATAGG -> GCCACATAGGT
TGCCCGAAGAG -> GCCCGAAGAGG
TGCCCGACGGG -> GCCCGACGGGT
TGCCCGCGGCC -> GCCCGCGGCCG
TGCCCGTCGTA -> GCCCGTCGTAC
TGCCTAAAGTA -> GCCTAAAGTAG
TGCCTCGATCC -> GCCTCGATCCA
TGCCTTGGGGG -> GCCTTGGGGGT
TGCGCACATGA -> GCGCACATGAC
TGCGGGACTCA -> GCGGGACTCAC
TGCGGTGAATC -> GCGGTGAATCG
TGCGTTACGTG -> GCGTTACGTGT
TGCGTTCCGCG -> GCGTTCCGCGG
TGCTAATGAGA -> GCTAATGAGAG
TGCTATATTTG -> GCTATATTTGC
TGCTATCCAGC -> GCTATCCAGCC
TGCTATCTGTG -> GCTATCTGTGT
TGCTGTTGTTT -> GCTGTTGTTTA
TGCTTAACCCG -> GCTTAACCCGG
TGCTTGACCAA -> GCTTGACCAAC
TGCTTTCTAGA -> GCTTTCTAGAG
TGGAAACCTCT -> GGAAACCTCTT
TGGAGGATCGT -> GGAGGATCGTC
TGGAGGCATGC -> GGAGGCATGCG
TGGATACCCGG -> GGATACCCGGC
TGGCACTTCTG -> GGCACTTCTGA
TGGCAGCAAAA -> GGCAGCAAAAT
TGGCGATTTGT -> GGCGATTTGTT
TGGCGCACGTA -> GGCGCACGTAC
TGGCGCATCAC -> GGCGCATCACT
TGGCGTACAGA -> GGCGTACAGAG
TGGCTCGTGTT -> GGCTCGTGTTG
TGGCTTATTAA -> GGCTTATTAAT
TGGGACCGACA -> GGGACCGACAG
TGGGATGGTGC -> GGGATGGTGCG
TGGGATTCCTA -> GGGATTCCTAG
TGGGGGTGTGT -> GGGGGTGTGTA
TGGGGTACAGA -> GGGGTACAGAC
TGGGTTGCGGT -> GGGTTGCGGTG
TGGTAATAAGG -> GGTAATAAGGT
TGGTCAGGTTT -> GGTCAGGTTTG
TGGTGAAGGCT -> GGTGAAGGCTG
TGGTGCAGCGT -> GGTGCAGCGTA
TGGTGCGGGAC -> GGTGCGGGACT
TGGTGGCACTT -> GGTGGCACTTC
TGGTTCTGTAC -> GGTTCTGTACC
TGTAAAAGGAT -> GTAAAAGGATG
TGTAATACCGA -> GTAATACCGAG
TGTAATCTCCT -> GTAATCTCCTT
TGTACCAACCT -> GTACCAACCTG
TGTACGCGTGT -> GTACGCGTGTA
TGTAGAGTGAG -> GTAGAGTGAGA
TGTAGATCTAT -> GTAGATCTATT
TGTAGCGGCCC -> GTAGCGGCCCC
TGTAGGACAGG -> GTAGGACAGGA
TGTAGGGACTC -> GTAGGGACTCC
TGTATAGCGTA -> GTATAGCGTAC
TGTATCCAGTT -> GTATCCAGTTG
TGTATCTAGGG -> GTATCTAGGGA
TGTATGATCCC -> GTATGATCCCC
TGTCCGGGTGT -> GTCCGGGTGTC
TGTCCGTATAA -> GTCCGTATAAC
TGTCGTATGTG -> GTCGTATGTGC
TGTCTCTGTGT -> GTCTCTGTGTT
TGTGCATCAGC -> GTGCATCAGCA
TGTGCCCGTCG -> GTGCCCGTCGT
TGTGCGCACAT -> GTGCGCACATG
TGTGGCTCGTG -> GTGGCTCGTGT
TGTGTAGAGTG -> GTGTAGAGTGA
TGTGTAGATCT -> GTGTAGATCTA
TGTGTATCTAG -> GTGTATCTAGG
TGTGTTCATCG -> GTGTTCATCGT
TGTTAGATTTG -> GTTAGATTTGA
TGTTCATCGTG -> GTTCATCGTGG
TGTTGATGTAG -> GTTGATGTAGG
TGTTGGGGTAC -> GTTGGGGTACA
TGTTGTTTACC -> GTTGTTTACCC
TGTTTAATAAA -> GTTTAATAAAG
TGTTTACCCTC -> GTTTACCCTCC
TGTTTCGCCGA -> GTTTCGCCGAC
TGTTTTTGTAT -> GTTTTTGTATA
TTAAAAACGTA -> TAAAAACGTAT
TTAAACGGCGT -> TAAACGGCGTC
TTAAACGTTAG -> TAAACGTTAGG
TTAAATAATGT -> TAAATAATGTA
TTAACCCGGCA -> TAACCCGGCAT
TTAACTGACAT -> TAACTGACATA
TTAAGGAAATC -> TAAGGAAATCA
TTAATAAAGAT -> TAATAAAGATT
TTAATAAGATC -> TAATAAGATCC
TTAATCAATCG -> TAATCAATCGT
TTACCCTCCCT -> TACCCTCCCTG
TTACCTTCCGT -> TACCTTCCGTT
TTACGCGGCCG -> TACGCGGCCGT
TTACGTACATT -> TACGTACATTC
TTACGTGTGCA -> TACGTGTGCAT
TTACTGTCCGG -> TACTGTCCGGG
TTACTTAAACG -> TACTTAAACGT
TTAGAATATCT -> TAGAATATCTA
TTAGATTTGAA -> TAGATTTGAAC
TTAGCAAAAAC -> TAGCAAAAACT
TTAGCCCGAGA -> TAGCCCGAGAT
TTAGGAGGCCT -> TAGGAGGCCTT
TTAGGCGAGTA -> TAGGCGAGTAG
TTAGGTATCAG -> TAGGTATCAGC
TTAGTTCTAAT -> TAGTTCTAATC
TTATAACCACC -> TATAACCACCC
TTATAGCTTGG -> TATAGCTTGGA
TTATCAGTGCC -> TATCAGTGCCA
TTATGGTGGCA -> TATGGTGGCAC
TTATTAATAAG -> TATTAATAAGA
TTCACCGCACG -> TCACCGCACGA
TTCACGAGCTA -> TCACGAGCTAA
TTCACGCCAGG -> TCACGCCAGGA
TTCAGGTCTAT -> TCAGGTCTATA
TTCATCGTGGG -> TCATCGTGGGT
TTCATGCAGAT -> TCATGCAGATC
TTCATTCACGA -> TCATTCACGAG
TTCATTTCTAA -> TCATTTCTAAA
TTCCAGAAGGA -> TCCAGAAGGAA
TTCCAGCGACG -> TCCAGCGACGG
TTCCGATAACC -> TCCGATAACCA
TTCCGCGGCCG -> TCCGCGGCCGT
TTCCGCTAGAT -> TCCGCTAGATT
TTCCGGACGTG -> TCCGGACGTGA
TTCCGTTCCGA -> TCCGTTCCGAT
TTCCTAGTTCC -> TCCTAGTTCCA
TTCCTCCCCAT -> TCCTCCCCATA
TTCCTTATAAC -> TCCTTATAACC
TTCGAAGACAC -> TCGAAGACACG
TTCGCCGACTC -> TCGCCGACTCT
TTCGCTGCCCG -> TCGCTGCCCGA
TTCGCTTGCAA -> TCGCTTGCAAA
TTCGGCGGCGG -> TCGGCGGCGGG
TTCGTACGAAC -> TCGTACGAACT
TTCTAAACGAG -> TCTAAACGAGA
TTCTAATCCAT -> TCTAATCCATG
TTCTAATCTGG -> TCTAATCTGGA
TTCTACCGAAG -> TCTACCGAAGA
TTCTAGAACCC -> TCTAGAACCCA
TTCTAGAGTCA -> TCTAGAGTCAT
TTCTCCGGGGG -> TCTCCGGGGGC
TTCTGAACATC -> TCTGAACATCG
TTCTGTACCAA -> TCTGTACCAAC
TTCTGTTTCGC -> TCTGTTTCGCC
TTCTTAAATAA -> TCTTAAATAAT
TTCTTTATAGC -> TCTTTATAGCT
TTCTTTCCTTA -> TCTTTCCTTAT
TTGAAAGTTGT -> TGAAAGTTGTT
TTGAACTCCAG -> TGAACTCCAGT
TTGACCAACCC -> TGACCAACCCA
TTGAGAATGCC -> TGAGAATGCCC
TTGAGACGTTA -> TGAGACGTTAG
TTGAGCGTCAT -> TGAGCGTCATT
TTGATGGCGAT -> TGATGGCGATT
TTGATGTAAAA -> TGATGTAAAAG
TTGATGTAGGG -> TGATGTAGGGA
TTGCAAAGCCT -> TGCAAAGCCTG
TTGCAACAGGT -> TGCAACAGGTT
TTGCAACGCAC -> TGCAACGCACT
TTGCAAGCATA -> TGCAAGCATAC
TTGCAGTAAGA -> TGCAGTAAGAG
TTGCCCGCGGC -> TGCCCGCGGCC
TTGCCTTGGGG -> TGCCTTGGGGG
TTGCGGTGAAT -> TGCGGTGAATC
TTGCGTTACGT -> TGCGTTACGTG
TTGCTATATTT -> TGCTATATTTG
TTGGAGGCATG -> TGGAGGCATGC
TTGGCTTATTA -> TGGCTTATTAA
TTGGGATTCCT -> TGGGATTCCTA
TTGGGGGTGTG -> TGGGGGTGTGT
TTGGGGTACAG -> TGGGGTACAGA
TTGGTGAAGGC -> TGGTGAAGGCT
TTGTATAGCGT -> TGTATAGCGTA
TTGTCTCTGTG -> TGTCTCTGTGT
TTGTGGCTCGT -> TGTGGCTCGTG
TTGTTAGATTT -> TGTTAGATTTG
TTGTTTACCCT -> TGTTTACCCTC
TTGTTTTTGTA -> TGTTTTTGTAT
TTTAATAAAGA -> TTAATAAAGAT
TTTAATCAATC -> TTAATCAATCG
TTTACCCTCCC -> TTACCCTCCCT
TTTACGCGGCC -> TTACGCGGCCG
TTTAGAATATC -> TTAGAATATCT
TTTAGCAAAAA -> TTAGCAAAAAC
TTTAGTTCTAA -> TTAGTTCTAAT
TTTATAGCTTG -> TTATAGCTTGG
TTTCCTTATAA -> TTCCTTATAAC
TTTCGAAGACA -> TTCGAAGACAC
TTTCGCCGACT -> TTCGCCGACTC
TTTCGCTGCCC -> TTCGCTGCCCG
TTTCTAAACGA -> TTCTAAACGAG
TTTCTAGAGTC -> TTCTAGAGTCA
TTTCTCCGGGG -> TTCTCCGGGGG
TTTGAAAGTTG -> TTGAAAGTTGT
TTTGAACTCCA -> TTGAACTCCAG
TTTGAGAATGC -> TTGAGAATGCC
TTTGATGTAAA -> TTGATGTAAAA
TTTGCAACGCA -> TTGCAACGCAC
TTTGCAGTAAG -> TTGCAGTAAGA
TTTGCCTTGGG -> TTGCCTTGGGG
TTTGCTATATT -> TTGCTATATTT
TTTGGTGAAGG -> TTGGTGAAGGC
TTTGTATAGCG -> TTGTATAGCGT
TTTGTTAGATT -> TTGTTAGATTT
TTTTACGCGGC -> TTTACGCGGCC
TTTTGATGTAA -> TTTGATGTAAA
TTTTGCCTTGG -> TTTGCCTTGGG
TTTTGCTATAT -> TTTGCTATATT
TTTTGTATAGC -> TTTGTATAGCG
TTTTTGTATAG -> TTTTGTATAGC

